query	truth	pred_sim	pred_norm
怎么让页面上的按钮能触发自定义动作	页面上的按钮怎么实现触发自定义动作	页面上的按钮怎么实现触发自定义动作	页面上的按钮怎么实现触发自定义动作
页面上的按钮如何做到触发自定义动作	页面上的按钮怎么实现触发自定义动作	页面上的按钮怎么实现触发自定义动作	页面上的按钮怎么实现触发自定义动作
页面上的按钮怎么实现触发自定义动作	页面上的按钮怎么实现触发自定义动作	页面上的按钮怎么实现触发自定义动作	页面上的按钮怎么实现触发自定义动作
刚刚参加面试的应聘者到了，需要去接待一下	下午有个算法工程师来面试，帮忙接待下	面试的人今天早上就到了，安排一下	下午有个算法工程师来面试，帮忙接待下
今天会有10位面试者，帮忙接待一下	下午有个算法工程师来面试，帮忙接待下	下午有个算法工程师来面试，帮忙接待下	下午有个算法工程师来面试，帮忙接待下
今天的面试时群面，帮我接待一下面试者	下午有个算法工程师来面试，帮忙接待下	面试的人今天早上就到了，安排一下	下午有个算法工程师来面试，帮忙接待下
面试java的同学到了	下午有个算法工程师来面试，帮忙接待下	下午有个算法工程师来面试，帮忙接待下	下午有个算法工程师来面试，帮忙接待下
面试者今天上午10点会到，安排一下	下午有个算法工程师来面试，帮忙接待下	面试的人今天早上就到了，安排一下	下午有个算法工程师来面试，帮忙接待下
今天面试的人已经到了，帮我接待一下	下午有个算法工程师来面试，帮忙接待下	面试的人今天早上就到了，安排一下	下午有个算法工程师来面试，帮忙接待下
今天应聘的人已经到公司，安排面试	下午有个算法工程师来面试，帮忙接待下	面试的人今天早上就到了，安排一下	下午有个算法工程师来面试，帮忙接待下
今天下午面试java的人到了，安排一下	下午有个算法工程师来面试，帮忙接待下	下午有个算法工程师来面试，帮忙接待下	下午有个算法工程师来面试，帮忙接待下
明天来面试的新人统一安排在101大会议室	下午有个算法工程师来面试，帮忙接待下	面试的人今天早上就到了，安排一下	下午有个算法工程师来面试，帮忙接待下
下午有个算法工程师来面试，帮忙接待下	下午有个算法工程师来面试，帮忙接待下	下午有个算法工程师来面试，帮忙接待下	下午有个算法工程师来面试，帮忙接待下
替我接待一下今天来面试的人	下午有个算法工程师来面试，帮忙接待下	接待新同事入职	明天有一批新入职人员前来报道，请安排接待
我的生日礼物怎么领取啊	我要领生日礼物	小e，你好！我要领一下我的生日礼物	我要领生日礼物
公司对员工的生日有什么福利吗	我要领生日礼物	公司关于员工的生日有什么活动安排吗	我要领生日礼物
我下周就过生日了，公司可以提供什么福利吗	我要领生日礼物	小e，你好！我要领一下我的生日礼物	我要领生日礼物
我现在可以领我的生日礼物吗	我要领生日礼物	小e，你好！我要领一下我的生日礼物	我要领生日礼物
我生日那天公司会给我什么礼物吗	我要领生日礼物	小e，你好！我要领一下我的生日礼物	我要领生日礼物
今年我的生日公司有哪些礼物送啊	我要领生日礼物	小e，你好！我要领一下我的生日礼物	我要领生日礼物
我想查一查公司对员工的生日礼物有哪些	我要领生日礼物	小e，你好！我要领一下我的生日礼物	我要领生日礼物
我要领生日礼物	我要领生日礼物	我要领生日礼物	我要领生日礼物
消息服务连接有问题？	消息服务连接不上？	消息服务连接不上？	消息服务连接不上？
消息服务连接失败？	消息服务连接不上？	消息服务连接不上？	消息服务连接不上？
消息服务连不上了？	消息服务连接不上？	消息服务连接不上？	消息服务连接不上？
消息服务无法建立联系？	消息服务连接不上？	消息服务连接不上？	消息服务连接不上？
消息服务连接不成功？	消息服务连接不上？	消息服务连接不上？	消息服务连接不上？
无犯罪记录如何查询	无犯罪记录怎么查询	无犯罪记录怎么查询	无犯罪记录怎么查询
请我查找无犯罪记录	无犯罪记录怎么查询	看下无犯罪记录	无犯罪记录怎么查询
如何查询无犯罪记录	无犯罪记录怎么查询	无犯罪记录怎么查询	无犯罪记录怎么查询
怎么看无犯罪记录	无犯罪记录怎么查询	哪里可以看到无犯罪记录	无犯罪记录怎么查询
找谁要无犯罪记录	无犯罪记录怎么查询	哪里可以看到无犯罪记录	无犯罪记录怎么查询
无犯罪记录怎么查	无犯罪记录怎么查询	无犯罪记录怎么查询	无犯罪记录怎么查询
查询无犯罪记录	无犯罪记录怎么查询	无犯罪记录怎么查询	无犯罪记录怎么查询
我要查询无犯罪记录	无犯罪记录怎么查询	无犯罪记录怎么查询	无犯罪记录怎么查询
异构系统表单相关问题	异构系统表单相关问题	异构系统表单相关问题	异构系统表单相关问题
异构系统的表单能不能作为列表和浏览按钮展示在oa里	异构系统表单相关问题	异构系统的表单可不可以作为列表和浏览按钮在oa里显示出来	异构系统表单相关问题
异构系统的表单可不可以在oa里显示成列表和浏览按钮	异构系统表单相关问题	异构系统的表单可不可以作为列表和浏览按钮在oa里显示出来	异构系统表单相关问题
我下个月就离职了，下个月的手机话费还可以报销吗	我要申请手机话费	我可以申请报销这个月的手机话费吗	我要申请手机话费
我想报销这个月的手机话费	我要申请手机话费	我可以申请报销这个月的手机话费吗	我要申请手机话费
我今年刚入职的可以申请手机话费吗	我要申请手机话费	我要申请手机话费	我要申请手机话费
我上个月和客户联系比较多，所以我想申请手机话费	我要申请手机话费	上个月的手机话费这个月可以申请吗	我要申请手机话费
我的手机话费不够用了我要申请手机话费	我要申请手机话费	我要申请手机话费	我要申请手机话费
手机话费应该怎么申请啊	我要申请手机话费	上个月的手机话费这个月可以申请吗	我要申请手机话费
我上个月手机话费花了100块可以报销吗	我要申请手机话费	我可以申请报销这个月的手机话费吗	我要申请手机话费
我这个月的手机话费可以报销吗	我要申请手机话费	我可以申请报销这个月的手机话费吗	我要申请手机话费
小e需要单独购买吗？	想问下，我们小e是非标功能?	如何购买第三方产品	要采购第三方产品，如何处理
小e是属于非标功能吗？	想问下，我们小e是非标功能?	想问下，我们小e是非标功能?	想问下，我们小e是非标功能?
小e是非标准功能吗？	想问下，我们小e是非标功能?	小e是否属于标准功能？	想问下，我们小e是非标功能?
小e是否属于非标功能？	想问下，我们小e是非标功能?	想问下，我们小e是非标功能?	想问下，我们小e是非标功能?
想问下，我们小e是非标功能?	想问下，我们小e是非标功能?	想问下，我们小e是非标功能?	想问下，我们小e是非标功能?
你们的系统安全做得怎么样？	系统安全问题找谁	你们系统安全措施有哪些？	系统安全问题找谁
系统安全专家有哪些？	系统安全问题找谁	系统安全问题找谁	系统安全问题找谁
安全方案咨询	系统安全问题找谁	你们系统安全措施有哪些？	系统安全问题找谁
安全等级保护专家有哪些？	系统安全问题找谁	安全等级保护找谁？	系统安全问题找谁
系统安全能保证吗？	系统安全问题找谁	你们如何保证系统安全？	系统安全问题找谁
安全测试没通过	系统安全问题找谁	压力测试前需要做什么准备工作	压测相关问题
安全补丁包问题找谁？	系统安全问题找谁	这个月的补丁包什么时候发布？	这个月的补丁包什么时候发布？
安全包拦截	系统安全问题找谁	安全包等该怎么打？	安全包等该怎么打？
你们系统的安全等级保护怎么样？	系统安全问题找谁	你们系统是怎么解决安全等级保护问题的？	系统安全问题找谁
系统安全相关问题咨询谁？	系统安全问题找谁	系统安全问题找谁	系统安全问题找谁
安全等保相关问题找谁？	系统安全问题找谁	安全等保相关咨询	系统安全问题找谁
安全报告事宜找谁	系统安全问题找谁	你们系统安全措施有哪些？	系统安全问题找谁
安全等保措施有哪些？	系统安全问题找谁	安全等保相关咨询	系统安全问题找谁
系统安全问题找谁	系统安全问题找谁	系统安全问题找谁	系统安全问题找谁
协同区用的是文档内容元素，在后台选出了文档内容后，前台不能显示是怎么回事	移动门户问题	新建文档目录窗口，必填项标识展示位置不贴合的问题找谁	新建文档目录窗口，必填项标识展示位置不贴合的问题找谁
移动门户问题	移动门户问题	移动门户问题	移动门户问题
直接把整个页面放到门户菜单里是怎么设置的	移动门户问题	我发现我没法编辑门户元素？	移动门户问题
你们的门户元素都是文档信息吗?	移动门户问题	在门户中可以显示所有文档中的最新5条吗	移动门户问题
元素样式能随着主题切换而变化吗	移动门户问题	页面上的按钮怎么实现触发自定义动作	页面上的按钮怎么实现触发自定义动作
移动门户配好了，如果移动端要出来，还要做什么操作	移动门户问题	移动端附件上传字段是否支持排序和重命名的需求可以实现吗	移动端附件上传字段是否支持排序和重命名的需求可以实现吗
门户主题与元素问题	移动门户问题	门户主题切换出错	移动门户问题
门户元素字体怎么调呀	移动门户问题	我发现我没法编辑门户元素？	移动门户问题
门户菜单问题，菜单显示不正确	移动门户问题	我发现我没法编辑门户元素？	移动门户问题
门户元素无法被修改？	移动门户问题	我发现我没法编辑门户元素？	移动门户问题
你们门户集成主要集成什么内容?	移动门户问题	移动门户问题	移动门户问题
泛微门户中的元素是需要自己开发的吗?	移动门户问题	如果我想了解泛微专家能够提供哪些支持，擅长哪些方面，有哪些成功案例，应该找谁协助	如果我想了解泛微专家能够提供哪些支持，擅长哪些方面，有哪些成功案例，应该找谁协助
门户元素不能编辑怎么办	移动门户问题	我发现我没法编辑门户元素？	移动门户问题
你们有移动门户吗?	移动门户问题	请为我开通邮箱	我要开通邮箱
老板让我改门户元素我改不了	移动门户问题	我发现我没法编辑门户元素？	移动门户问题
如果客户只能够看到顶部一个门户菜单，怎么解决?	移动门户问题	客户流程功能更改找谁？	客户之前开发的一个功能要作废，帮忙处理下？
找一个能改门户元素的方法	移动门户问题	我发现我没法编辑门户元素？	移动门户问题
谁负责打印电子合同扫描件？	想要电子投标合同扫描件	需要电子合同扫描件走什么流程？	想要电子投标合同扫描件
这个电子合同扫描件有问题，能帮我重新扫描一份吗	想要电子投标合同扫描件	需要电子合同扫描件走什么流程？	想要电子投标合同扫描件
我想要这个电子合同的扫描件去找谁	想要电子投标合同扫描件	把电子合同扫描件发给我	想要电子投标合同扫描件
这个电子投标合同能扫描吗	想要电子投标合同扫描件	今天可以扫描电子投标合同吗	想要电子投标合同扫描件
我的电子投标合同帮我扫描了吗	想要电子投标合同扫描件	今天可以扫描电子投标合同吗	想要电子投标合同扫描件
电子投标合同扫描的相关问题要联系谁	想要电子投标合同扫描件	今天可以扫描电子投标合同吗	想要电子投标合同扫描件
想要电子投标合同扫描件	想要电子投标合同扫描件	想要电子投标合同扫描件	想要电子投标合同扫描件
电子合同扫描件找谁要？	想要电子投标合同扫描件	需要电子合同扫描件走什么流程？	想要电子投标合同扫描件
怎么用建模构建应用	应用如何用建模构建	应用如何用建模构建	应用如何用建模构建
应用怎么用建模发挥作用	应用如何用建模构建	应用如何用建模做到	应用如何用建模构建
应用如何用建模构建	应用如何用建模构建	应用如何用建模构建	应用如何用建模构建
无法看到会议	无法看到会议	无法看到会议	无法看到会议
看不到创建的会议	无法看到会议	无法看到会议	无法看到会议
会议创建了，但是流程清单中看不到会议	无法看到会议	无法看到会议	无法看到会议
会议看不到怎么办	无法看到会议	会议的短信提醒没有收到	会议室设置相关问题
请帮我申请办理上海的居住证	我要办理居住证	我带了相关材料，请帮我办理居住证	我要办理居住证
办居住证要啥材料，给我办一下，我准备材料	我要办理居住证	我带了相关材料，请帮我办理居住证	我要办理居住证
能给我办个居住证不	我要办理居住证	我没有居住证，帮我办一个	我要办理居住证
我来上海工作三年了，可以办居住证吗	我要办理居住证	我带了相关材料，请帮我办理居住证	我要办理居住证
你好，我要办一下居住证	我要办理居住证	我要办理居住证	我要办理居住证
根据政策，我可以办居住证了，帮我办理一下	我要办理居住证	我没有居住证，帮我办一个	我要办理居住证
我要办理居住证	我要办理居住证	我要办理居住证	我要办理居住证
居住证怎么办	我要办理居住证	我要办理居住证	我要办理居住证
项目实施成本是怎么核算的？	项目实施成本是多少？	项目实施成本如何估计？	项目实施成本是多少？
项目实施怎么收取费用？	项目实施成本是多少？	已发生、审批中费用能在哪里查询到	已发生、审批中费用能在哪里查询到
项目成本是怎么计算的？	项目实施成本是多少？	项目实施成本如何估计？	项目实施成本是多少？
项目实施是如何进行收费的？	项目实施成本是多少？	项目上扣钱了，我想知道扣在哪	项目上扣钱了，我想知道扣在哪
项目实施成本是按什么标准进行估计的？	项目实施成本是多少？	项目实施成本如何估计？	项目实施成本是多少？
项目成本是按什么标准计算的？	项目实施成本是多少？	项目实施成本如何估计？	项目实施成本是多少？
项目实施成本核算标准是怎样的？	项目实施成本是多少？	项目实施成本如何估计？	项目实施成本是多少？
项目实施成本核算找谁？	项目实施成本是多少？	项目实施成本如何估计？	项目实施成本是多少？
我们有ecology8.0的压测报告吗	我们有ecology8.0的压测报告吗	我们有ecology8.0的压测报告吗	我们有ecology8.0的压测报告吗
我们有ecology9.0的压测报告吗	我们有ecology8.0的压测报告吗	我们有ecology8.0的压测报告吗	我们有ecology8.0的压测报告吗
我们有emobile压测报告吗	我们有ecology8.0的压测报告吗	系统登录支持em7的h5移动登录页面吗。	系统登录支持em7的h5移动登录页面吗。
我系统里的照片需要更换下	我要换系统照片	可以更换系统里的照片吗	我要换系统照片
如何更换我系统里的照片	我要换系统照片	更换系统照片的步骤	我要换系统照片
请帮我换一张公司系统照片	我要换系统照片	我要换系统照片	我要换系统照片
我要换下系统里的照片	我要换系统照片	可以更换系统里的照片吗	我要换系统照片
麻烦帮我换下系统照片	我要换系统照片	更换系统照片的步骤	我要换系统照片
我的大头照需要更新	我要换系统照片	麻烦帮我换下系统头像	我要换系统头像
我要换系统照片	我要换系统照片	我要换系统照片	我要换系统照片
换系统里我的照片方便吗，谢谢	我要换系统照片	我要换系统照片	我要换系统照片
请尽快为我更换系统照片	我要换系统照片	更换系统照片的步骤	我要换系统照片
收款未结算表中的未验收是什么意思？	在收款未结算表中写未验收是什么情况？	收款未结算表中的未验收说明什么？	在收款未结算表中写未验收是什么情况？
在收款未结算表中写未验收是什么情况？	在收款未结算表中写未验收是什么情况？	在收款未结算表中写未验收是什么情况？	在收款未结算表中写未验收是什么情况？
为什么在收款未结算表中还有未验收这一项？	在收款未结算表中写未验收是什么情况？	为什么在收款未结算表中有未验收的说明？	在收款未结算表中写未验收是什么情况？
收款未结算表中的未验收是指什么？	在收款未结算表中写未验收是什么情况？	收款未结算表中的未验收说明什么？	在收款未结算表中写未验收是什么情况？
收款未结算表中写未验收是什么原因？	在收款未结算表中写未验收是什么情况？	在收款未结算表中写未验收是什么情况？	在收款未结算表中写未验收是什么情况？
收款未结算表中写未验收是因为什么？	在收款未结算表中写未验收是什么情况？	在收款未结算表中写未验收是什么情况？	在收款未结算表中写未验收是什么情况？
收款未结算表中的未验收意味着什么？	在收款未结算表中写未验收是什么情况？	收款未结算表中的未验收说明什么？	在收款未结算表中写未验收是什么情况？
为什么在收款未结算表中显示未验收？	在收款未结算表中写未验收是什么情况？	为什么在收款未结算表中有未验收的说明？	在收款未结算表中写未验收是什么情况？
顺丰明天能到吗	我的快递到哪里了	客户方面要求先付百分之三十的项目款	特殊-其他
我的快递到哪里了	我的快递到哪里了	我的快递到哪里了	我的快递到哪里了
顺丰快递到了吗	我的快递到哪里了	看看我的快递到哪里了	我的快递到哪里了
查询快递	我的快递到哪里了	帮我查一查我的快递	我的快递到哪里了
小e帮我查一下我昨天寄给河北周扬的快递到哪里	我的快递到哪里了	我要寄快递	我要寄快递
昨天我买的书今天到了吗	我的快递到哪里了	午饭几点开始	用餐时间
我昨天寄出去的客户资料到哪里了	我的快递到哪里了	昨天江苏公司寄给我的资料今天到了吗	我的快递到哪里了
昨天寄给合肥分公司的资料今天到了吗	我的快递到哪里了	昨天江苏公司寄给我的资料今天到了吗	我的快递到哪里了
我的快递要是到了帮我签收一下	我的快递到哪里了	寄给合肥的快递什么时候签收	我的快递到哪里了
圆通快递到了吗	我的快递到哪里了	帮我查一查我的快递	我的快递到哪里了
小e帮我看看河北河阳寄给我的资料到哪里了	我的快递到哪里了	昨天江苏公司寄给我的资料今天到了吗	我的快递到哪里了
帮我查一下这个快递现在到哪里了	我的快递到哪里了	看看我的快递到哪里了	我的快递到哪里了
新客户合同能和发票一起寄出吗	新客户合同能和发票一起寄出吗	新客户合同能和发票一起寄出吗	新客户合同能和发票一起寄出吗
给新客户发票邮寄的相关问题联系谁	新客户合同能和发票一起寄出吗	给新客户的发票可以单独邮寄吗	新客户合同能和发票一起寄出吗
新客户发票邮寄要走什么流程	新客户合同能和发票一起寄出吗	给新客户的发票可以单独邮寄吗	新客户合同能和发票一起寄出吗
新客户的发票是由谁邮寄的	新客户合同能和发票一起寄出吗	给新客户的发票可以单独邮寄吗	新客户合同能和发票一起寄出吗
新客户的发票一起邮寄了吗	新客户合同能和发票一起寄出吗	给新客户的发票可以单独邮寄吗	新客户合同能和发票一起寄出吗
新客户的合同能和发票一起寄出吗	新客户合同能和发票一起寄出吗	新客户合同能和发票一起寄出吗	新客户合同能和发票一起寄出吗
新客户的合同发票都寄出了吗	新客户合同能和发票一起寄出吗	新客户合同的合同和发票什么时候能一起寄出啊	新客户合同能和发票一起寄出吗
有位新客户需要发票，可以和合同一并寄出吗	新客户合同能和发票一起寄出吗	新客户合同能和发票一起寄出吗	新客户合同能和发票一起寄出吗
协同区怎么设置元素只取创建人申请的流程	协同区问题	协同区怎么选择到具体的流程	协同区问题
协同区和协作区是一样的吗	协同区问题	协同区问题	协同区问题
协同区问题	协同区问题	协同区问题	协同区问题
如何进行多人协同搭建?	协同区问题	运维平台需要集成到第三方监控平台	运维平台相关问题
协同区选不到表单字段	协同区问题	正式系统上，单页协作下，参与情况里面的图标和字重叠了怎么解决	正式系统上，单页协作下，参与情况里面的图标和字重叠了怎么解决
英文翻译相关问题应该找谁？	我需要英文翻译，应该找谁	我想咨询英文翻译应该找谁？	我需要英文翻译，应该找谁
帮我查一下英文翻译该问谁？	我需要英文翻译，应该找谁	我想咨询英文翻译应该找谁？	我需要英文翻译，应该找谁
英文翻译找谁负责？	我需要英文翻译，应该找谁	我需要英文翻译，应该找谁	我需要英文翻译，应该找谁
谁负责英文翻译？	我需要英文翻译，应该找谁	我需要英文翻译，应该找谁	我需要英文翻译，应该找谁
你知道英文翻译找谁吗？	我需要英文翻译，应该找谁	我想咨询英文翻译应该找谁？	我需要英文翻译，应该找谁
资产组分权问题该找谁	资产管理相关问题	资产组分权问题	资产管理相关问题
怎样修改资产信息?	资产管理相关问题	在哪里修改资产信息	资产管理相关问题
如何修改资产相关信息	资产管理相关问题	在哪里修改资产信息	资产管理相关问题
资产入库不成功，生成不了资产	资产管理相关问题	资产相关流程提交不成功	资产管理相关问题
你们的资产管理主要是管什么?	资产管理相关问题	资产管理相关问题	资产管理相关问题
资产导入出错了	资产管理相关问题	资产相关流程提交不成功	资产管理相关问题
资产怎样入库?	资产管理相关问题	申请资产	领用一些资产
资产导入失败了	资产管理相关问题	请问维修状态的资产谁有权限通过归还流程选择到这个资产	资产管理相关问题
新建资产资料时的管理员有什么权限?	资产管理相关问题	资产相关流程提交不成功	资产管理相关问题
资产要清理数据，重新导入	资产管理相关问题	资产相关流程提交不成功	资产管理相关问题
怎么对入库的资产进行报废处理	资产管理相关问题	想看看我的笔记本自用补贴该怎么申请	我要申请笔记本电脑自用补贴
想要了解一下资产组分权有关的问题	资产管理相关问题	资产组分权问题	资产管理相关问题
为何资产管理员看不到资产?	资产管理相关问题	资产管理相关问题	资产管理相关问题
资产导入报错	资产管理相关问题	资产相关流程提交不成功	资产管理相关问题
怎样查看资产情况?	资产管理相关问题	资产相关流程提交不成功	资产管理相关问题
我导入资产失败了，要找谁解决	资产管理相关问题	资产相关流程提交不成功	资产管理相关问题
资产领用、归还等动作如何与流程关联?	资产管理相关问题	我要申请笔记本电脑自用补贴	我要申请笔记本电脑自用补贴
如果我们资产管理系统，你们的资产流程能够自动生成资产台账码?	资产管理相关问题	资产相关流程提交不成功	资产管理相关问题
你们的资产管理功能里面，是否支持对于资产全生命周期的管理?	资产管理相关问题	资产相关流程提交不成功	资产管理相关问题
小e支持哪些功能	小e相关问题	请问下金格的具体功能	第三方产品功能
小e哪些功能需要开发	小e相关问题	项目中对功能有疑问找谁协助？	在项目中，有些功能不理解该怎么办
小e怎么申请	小e相关问题	小e相关问题	小e相关问题
小e需要打补丁包吗	小e相关问题	这个月的补丁包什么时候发布？	这个月的补丁包什么时候发布？
小e相关问题	小e相关问题	小e相关问题	小e相关问题
请发我一份工作微博模板	我想要个工作微博模板	我想要个工作微博模板	我想要个工作微博模板
可不可以发我工作微博模板	我想要个工作微博模板	能给我一份工作微博模板吗	我想要个工作微博模板
在哪里找工作微博模板	我想要个工作微博模板	能给我一份工作微博模板吗	我想要个工作微博模板
我急需工作微博模板	我想要个工作微博模板	有工作微博模板吗，给我一份吧	我想要个工作微博模板
方便给我一个工作微博模板吗	我想要个工作微博模板	我想要个工作微博模板	我想要个工作微博模板
我想找个工作微博模板	我想要个工作微博模板	我想要个工作微博模板	我想要个工作微博模板
工作微博模板你那边有吗，发我一份	我想要个工作微博模板	我想要个工作微博模板	我想要个工作微博模板
工作微博模板请给我一份	我想要个工作微博模板	有工作微博模板吗，给我一份吧	我想要个工作微博模板
请给我处理一下，我的奖金数额不对	我奖金错了	帮我查一下，这个月发的奖金不够	我奖金错了
请告诉我奖金发的不够怎么办，找谁解决	我奖金错了	帮我查一下，这个月发的奖金不够	我奖金错了
你知道奖金出错找谁处理吗	我奖金错了	我奖金错了	我奖金错了
我上个月的业绩奖金没有发	我奖金错了	我上个月奖金少发了	我奖金错了
你看看是谁负责奖金发放的，我这边出了点错	我奖金错了	帮我查一下，这个月发的奖金不够	我奖金错了
你把我的全勤奖算错了	我奖金错了	不影响现有控制逻辑l，就是加个描述的信息。客户需求就是预算科目，有对应的负责人。 这个加字段是新版本才有的功能吗?	特殊-其他
我奖金错了	我奖金错了	我奖金错了	我奖金错了
奖金发放错了怎么办	我奖金错了	我奖金错了	我奖金错了
怎么推荐	我要推荐	推荐的渠道	我要推荐
我很想推荐	我要推荐	我要推荐	我要推荐
推荐人的方法	我要推荐	推荐员工入职给多少钱	推荐奖励多少钱
推荐的方法	我要推荐	推荐的渠道	我要推荐
如何推荐	我要推荐	推荐员工入职给多少钱	推荐奖励多少钱
我要推荐	我要推荐	我要推荐	我要推荐
去哪里推荐人啊	我要推荐	推荐奖励多少钱	推荐奖励多少钱
到哪里推荐	我要推荐	推荐的渠道	我要推荐
下午2点可以寄快递吗	我要寄快递	我要寄快递	我要寄快递
把资料用顺丰寄出去	我要寄快递	昨天江苏公司寄给我的资料今天到了吗	我的快递到哪里了
王总让我帮他寄一份客户资料	我要寄快递	昨天江苏公司寄给我的资料今天到了吗	我的快递到哪里了
寄快递在前台寄么？公司快件	我要寄快递	我要寄快递	我要寄快递
我想把这份资料寄给客户	我要寄快递	昨天江苏公司寄给我的资料今天到了吗	我的快递到哪里了
寄给王子玉	我要寄快递	帮我寄个东西	我要寄快递
小林，给我把这个寄到宁波	我要寄快递	帮我寄个东西	我要寄快递
让前台下午之前把这份材料寄到社保局	我要寄快递	大概入职多久医保卡能够办好呀	我要领取医保卡
我要发个东西到北京	我要寄快递	帮我发起今天晚上	特殊-其他
我要寄个光盘	我要寄快递	你好，请问这个光盘，可以在今天寄出吗？	我要寄快递
我需要怎么申请公司的笔记本自用补贴	我要申请笔记本电脑自用补贴	我要申请笔记本电脑自用补贴	我要申请笔记本电脑自用补贴
我自己带了笔记本电脑，怎么申请补贴	我要申请笔记本电脑自用补贴	我要申请笔记本电脑自用补贴	我要申请笔记本电脑自用补贴
我没有用公司的电脑，我可以申请公司的笔记本自用补贴吗	我要申请笔记本电脑自用补贴	我上班用自己的电脑所以想申请笔记本自用补贴	我要申请笔记本电脑自用补贴
我可以领多少笔记本自用补贴	我要申请笔记本电脑自用补贴	通知行政部,领笔记本	领用一些资产
公司关于笔记本自用补贴可以怎么申请啊	我要申请笔记本电脑自用补贴	我要申请笔记本电脑自用补贴	我要申请笔记本电脑自用补贴
我要申请笔记本电脑自用补贴	我要申请笔记本电脑自用补贴	我要申请笔记本电脑自用补贴	我要申请笔记本电脑自用补贴
我上个月入职的但是我用的自己的笔记本，请问我可以领用补贴吗	我要申请笔记本电脑自用补贴	我要申请笔记本电脑自用补贴	我要申请笔记本电脑自用补贴
我现在上班用的是自己带的电脑，这样公司会有补贴吗	我要申请笔记本电脑自用补贴	我上班用自己的电脑所以想申请笔记本自用补贴	我要申请笔记本电脑自用补贴
我的出国签证和手续最快需要多久能够办好啊	我要办理出国手续签证	我下个月要去韩国，要办理一下出国手续签证	我要办理出国手续签证
出国的签证办理流程大概是什么	我要办理出国手续签证	出国手续签证办理可以找谁啊	我要办理出国手续签证
我今年下半年准备去日本，所以要办一个出国手续签证	我要办理出国手续签证	我下个月要去韩国，要办理一下出国手续签证	我要办理出国手续签证
我要办理出国的手续需要提前准备哪些材料啊	我要办理出国手续签证	你知道办入职大概必须要哪几种材料吗	办理入职我要准备哪些材料
我要办理出国手续签证	我要办理出国手续签证	我要办理出国手续签证	我要办理出国手续签证
出国的手续有哪些	我要办理出国手续签证	出国的手续办理有点麻烦	我要办理出国手续签证
麻烦你帮我办理一下出国手续签证	我要办理出国手续签证	我要办理出国手续签证	我要办理出国手续签证
我刚加入公司可以办理出国手续吗	我要办理出国手续签证	出国的手续办理有点麻烦	我要办理出国手续签证
投标人员资质证书发我下	要投标人员资质证书	请将投标人员资质证书给我	要投标人员资质证书
要投标人员资质证书	要投标人员资质证书	要投标人员资质证书	要投标人员资质证书
我需要投标人员资质证书	要投标人员资质证书	你这边有投标人员资质证书吗，有的话给我一份	要投标人员资质证书
投标人员资质证书有的话给我	要投标人员资质证书	请把投标人员资质证书给我	要投标人员资质证书
给我投标人员资质证书	要投标人员资质证书	请把投标人员资质证书给我	要投标人员资质证书
你这边有投标人员资质证书吗	要投标人员资质证书	你这边有投标人员资质证书吗，有的话给我一份	要投标人员资质证书
我要一份投标人员资质证书	要投标人员资质证书	请把投标人员资质证书给我	要投标人员资质证书
可以给我一份投标人员资质证书吗	要投标人员资质证书	你这边有投标人员资质证书吗，有的话给我一份	要投标人员资质证书
我签约的客户发新闻了吗？	我签约了新客户怎么没发新闻呢	我签约了新客户怎么没发新闻呢	我签约了新客户怎么没发新闻呢
为什么我的签约没有发新闻？	我签约了新客户怎么没发新闻呢	为什么新闻上没有我的签约？	我签约了新客户怎么没发新闻呢
我签约了新客户怎么没发新闻呢	我签约了新客户怎么没发新闻呢	我签约了新客户怎么没发新闻呢	我签约了新客户怎么没发新闻呢
签约了的客户怎么没有新闻呢？	我签约了新客户怎么没发新闻呢	我签约了新客户怎么没发新闻呢	我签约了新客户怎么没发新闻呢
我签的客户为什么没有发新闻？	我签约了新客户怎么没发新闻呢	我签约了新客户怎么没发新闻呢	我签约了新客户怎么没发新闻呢
桌面要清洁	我的桌子脏了，找谁清理	2楼会议室地上好多瓜子壳，打扫一下	我的桌子脏了，找谁清理
卫生间的马桶盖上太脏了	我的桌子脏了，找谁清理	你好，4楼c区这里往下滴水的问题啥时候给修下呢，每隔3-4分钟就会滴一次，不小心衣服和座椅就会被打湿	我办公室的空调坏了
找人清理一下会议室	我的桌子脏了，找谁清理	无法看到会议	无法看到会议
绿植要浇水	我的桌子脏了，找谁清理	2楼会议室地上好多瓜子壳，打扫一下	我的桌子脏了，找谁清理
会议室桌上有不少灰谁负责	我的桌子脏了，找谁清理	会议室如果冲突了，能设置成不允许提交吗	会议室设置相关问题
会议室有好多蟑螂啊	我的桌子脏了，找谁清理	无法看到会议	无法看到会议
地面要清理	我的桌子脏了，找谁清理	地面有水	我的桌子脏了，找谁清理
地板上都是水快给清理一下	我的桌子脏了，找谁清理	我的桌子脏了，找谁清理	我的桌子脏了，找谁清理
卫生间太脏了，打扫一下吧	我的桌子脏了，找谁清理	202会议室的桌子上有好多水，打扫一下	我的桌子脏了，找谁清理
我的桌子上有积水需要清理一下	我的桌子脏了，找谁清理	我的桌子脏了，找谁清理	我的桌子脏了，找谁清理
会议室需要打扫啦	我的桌子脏了，找谁清理	无法看到会议	无法看到会议
有蟑螂找谁	我的桌子脏了，找谁清理	啊我今天忘带key了	我忘带key了
收垃圾	我的桌子脏了，找谁清理	垃圾要处理	我的桌子脏了，找谁清理
地面脏了	我的桌子脏了，找谁清理	地上脏了	我的桌子脏了，找谁清理
定位不准的时候怎么办	有时候定位不准	定位经常不准	有时候定位不准
定位经常性不准	有时候定位不准	定位经常不准	有时候定位不准
定位准确度欠佳	有时候定位不准	定位经常不准	有时候定位不准
有时候定位不准	有时候定位不准	有时候定位不准	有时候定位不准
定位不准	有时候定位不准	定位经常不准	有时候定位不准
网页出现乱码	页面有乱码怎么办	页面有乱码怎么办	页面有乱码怎么办
各种乱码编码问题	页面有乱码怎么办	谁负责处理乱码问题	页面有乱码怎么办
客户系统一进入就乱码	页面有乱码怎么办	页面有乱码怎么办	页面有乱码怎么办
页面有乱码怎么办	页面有乱码怎么办	页面有乱码怎么办	页面有乱码怎么办
公司这边同意为新员工写介绍信吗	我要开介绍信	我明天要新的公司报道你可以帮我写一个介绍信吗	我要开介绍信
请帮我开一个介绍信	我要开介绍信	我要开介绍信	我要开介绍信
写介绍信要准备哪些材料啊	我要开介绍信	我要开介绍信	我要开介绍信
我要开介绍信	我要开介绍信	我要开介绍信	我要开介绍信
我已经辞职了还可以麻烦公司给我写个介绍信吗	我要开介绍信	我要开介绍信	我要开介绍信
我今年要评上海市的职称，公司可以给我写一个介绍信吗	我要开介绍信	我要开介绍信	我要开介绍信
我明天准备离职了，但是公司这边还可以给我写一个介绍信吗	我要开介绍信	我要开介绍信	我要开介绍信
介绍信应该怎么写	我要开介绍信	介绍信可以每个人都写吗	我要开介绍信
项目业绩核算有问题找谁？	项目业绩核算有问题找谁？	项目业绩核算有问题找谁？	项目业绩核算有问题找谁？
项目业绩核算数据有错	项目业绩核算有问题找谁？	项目业绩核算数据出问题找谁？	项目业绩核算有问题找谁？
谁负责项目业绩核算	项目业绩核算有问题找谁？	项目业绩核算有问题找谁？	项目业绩核算有问题找谁？
我今天要去客户那边出差，帮我借一下笔记本电脑	我要借用笔记本电脑	帮我借一台性能比较好的笔记本电脑	我要借用笔记本电脑
帮我借一台笔记本，我今天出差要用	我要借用笔记本电脑	我要借用笔记本电脑	我要借用笔记本电脑
我上个月借的笔记本电脑还没有登记啊	我要借用笔记本电脑	我上午的借的笔记本电脑鼠标不能用，帮我换一个	我要换个笔记本电脑
我要借用笔记本电脑	我要借用笔记本电脑	我要借用笔记本电脑	我要借用笔记本电脑
麻烦你帮我借一下mac笔记本电脑	我要借用笔记本电脑	帮我借一台性能比较好的笔记本电脑	我要借用笔记本电脑
公司的笔记本电脑是都可以借的吗	我要借用笔记本电脑	帮我看看公司还有几台笔记本电脑可以外借的	我要借用笔记本电脑
公司有平板电脑吗，我要给客户展示下方案	我要借用笔记本电脑	我需要在本地申请装一套e-office产品的demo系统，该怎么做	我需要在本地申请装一套e-office产品的demo系统，该怎么做
昨天借的笔记本电脑我今天还要继续续借一台	我要借用笔记本电脑	帮我借一台性能比较好的笔记本电脑	我要借用笔记本电脑
我们组今天开会要借6台笔记本电脑	我要借用笔记本电脑	帮我看看公司还有几台笔记本电脑可以外借的	我要借用笔记本电脑
如何提项目实施过程文档用章流程	项目实施过程文档盖章走什么流程？	项目实施过程文档需要盖章走什么流程？	项目实施过程文档盖章走什么流程？
公司项目实施过程文件盖章如何提流程	项目实施过程文档盖章走什么流程？	项目实施过程文件盖章在哪里提流程	项目实施过程文档盖章走什么流程？
项目实施过程文档用章要怎么申请啊	项目实施过程文档盖章走什么流程？	项目实施过程文档需要盖章走什么流程？	项目实施过程文档盖章走什么流程？
项目实施过程文档用章怎么走流程	项目实施过程文档盖章走什么流程？	项目实施过程文档需要盖章走什么流程？	项目实施过程文档盖章走什么流程？
项目实施过程文档盖章走什么流程？	项目实施过程文档盖章走什么流程？	项目实施过程文档盖章走什么流程？	项目实施过程文档盖章走什么流程？
项目实施过程文档用章申请怎么提流程	项目实施过程文档盖章走什么流程？	项目实施过程文档需要盖章走什么流程？	项目实施过程文档盖章走什么流程？
我需要项目实施过程文档盖章	项目实施过程文档盖章走什么流程？	我的这个项目实施过程文档要盖章	项目实施过程文档盖章走什么流程？
项目实施过程文档需要盖章如何申请	项目实施过程文档盖章走什么流程？	项目实施过程文档需要盖章走什么流程？	项目实施过程文档盖章走什么流程？
系统里我的个人介绍帮我换一下	我想更换系统信息	我要开介绍信	我要开介绍信
系统里怎么我的入职时间不对啊	我想更换系统信息	入职证明材料要什么	办理入职我要准备哪些材料
我刚刚发现系统里我的年龄信息不对啊	我想更换系统信息	我的系统里信息好像显示的不对，小e你现在可以就帮我改改吗	我想更换系统信息
修改系统里的个人介绍	我想更换系统信息	请尽快为我更换系统头像	我要换系统头像
公司系统里我的个人信息的性别弄错了	我想更换系统信息	修改人员信息找谁？	如何修改人员卡片信息？
请你帮我看看我的系统信息对不对	我想更换系统信息	我想更换系统信息	我想更换系统信息
小e你能帮我修改一下系统信息吗	我想更换系统信息	人员卡片信息可以更改吗？	如何修改人员卡片信息？
我的系统信息好像不对，帮我修改一下	我想更换系统信息	我想更换系统信息	我想更换系统信息
非投标合同扫描	想要非投标合同扫描件	想要非投标合同扫描件	想要非投标合同扫描件
非投标合同扫描的相关问题要联系谁	想要非投标合同扫描件	这个非投标合同能扫描吗	想要非投标合同扫描件
这个非投标合同扫描件有问题，能帮我重新扫描一份吗	想要非投标合同扫描件	想要非投标合同扫描件	想要非投标合同扫描件
我想要这个非投标合同的扫描件去找谁	想要非投标合同扫描件	想要非投标合同扫描件	想要非投标合同扫描件
把非投标合同扫描件发给我	想要非投标合同扫描件	想要非投标合同扫描件	想要非投标合同扫描件
我的非投标合同帮我扫描了吗	想要非投标合同扫描件	这个非投标合同帮我扫描一下	想要非投标合同扫描件
今天可以扫描非投标合同吗	想要非投标合同扫描件	这个非投标合同能扫描吗	想要非投标合同扫描件
谁解决客户安装失败的问题	这个客户安装出现了问题怎么处理？	这个客户安装出现了问题怎么处理？	这个客户安装出现了问题怎么处理？
客户安装出问题了	这个客户安装出现了问题怎么处理？	这个客户安装出现了问题怎么处理？	这个客户安装出现了问题怎么处理？
客户安装系统失败	这个客户安装出现了问题怎么处理？	搭建本地系统安装盘找谁要？	我要在本机搭建一套系统，要怎么获得安装盘
我的订单收到钱了吗	怎么查收款	复星的合同收款到账没	怎么查收款
我不知道是否收款	怎么查收款	没有收款金额是怎么回事？	收款相关问题
怎么查收款	怎么查收款	怎么查收款	怎么查收款
查看收款情况	怎么查收款	怎么查收款	怎么查收款
我上个月的项目收款到账多少	怎么查收款	怎么查收款	怎么查收款
帮我查看一下我的收款金额	怎么查收款	没有收款金额是怎么回事？	收款相关问题
我签得合同收到钱了吗	怎么查收款	我的合同收到钱了吗	怎么查收款
能帮我查一下公司收款信息吗	怎么查收款	哪些渠道可以查看收款信息	怎么查收款
更新联系信息咨询谁？	我们搬了新的办公地址，需要更改联系信息该找谁	我们搬了新的办公地址，需要更改联系信息该找谁	我们搬了新的办公地址，需要更改联系信息该找谁
更改联系信息找谁咨询？	我们搬了新的办公地址，需要更改联系信息该找谁	修改人员信息找谁？	如何修改人员卡片信息？
谁负责员工联系信息？	我们搬了新的办公地址，需要更改联系信息该找谁	我们搬了新的办公地址，需要更改联系信息该找谁	我们搬了新的办公地址，需要更改联系信息该找谁
谁负责维护员工的办公信息？	我们搬了新的办公地址，需要更改联系信息该找谁	办公信息需要修改找谁咨询？	我们搬了新的办公地址，需要更改联系信息该找谁
更改办公信息联系谁？	我们搬了新的办公地址，需要更改联系信息该找谁	办公信息需要修改找谁咨询？	我们搬了新的办公地址，需要更改联系信息该找谁
我要建模的操作手册	有没有建模的操作手册	有没有建模的操作手册	有没有建模的操作手册
有没有建模的操作手册	有没有建模的操作手册	有没有建模的操作手册	有没有建模的操作手册
建模的操作手册谁有	有没有建模的操作手册	有没有建模的操作手册	有没有建模的操作手册
流程测试需要修改什么默认设置？	我要修改什么默认设置项，在系统哪张表？	流程测试修改默认设置的数据标在哪里？	我要修改什么默认设置项，在系统哪张表？
流程默认设置项在哪张表进行更改？	我要修改什么默认设置项，在系统哪张表？	我们的流程标准功能有哪些	我们的流程标准功能有哪些
流程在什么位置修改默认设置项？	我要修改什么默认设置项，在系统哪张表？	在已办事宜中查看，流程的显示模板当前节点的模板吗？	在已办事宜中查看，流程的显示模板当前节点的模板吗？
我要修改什么默认设置项，在系统哪张表？	我要修改什么默认设置项，在系统哪张表？	我要修改什么默认设置项，在系统哪张表？	我要修改什么默认设置项，在系统哪张表？
流程在哪张数据表修改默认设置？	我要修改什么默认设置项，在系统哪张表？	预算变更流程提交后预算没有发生变化	预算变更流程提交后预算没有发生变化
工资给我发错了	我工资错了	工资发的不对吧	我工资错了
工资发错了吧	我工资错了	工资发的不对吧	我工资错了
好像我的工资发错了哎	我工资错了	工资发的不对吧	我工资错了
我工资算错了找谁	我工资错了	我工资错了	我工资错了
我工资核算少了，应该找财务处核实下吗	我工资错了	我要查工资	我要查工资
我工资感觉被财务处算错了	我工资错了	我工资错了	我工资错了
我工资不正确要怎么办啊	我工资错了	我工资错了	我工资错了
你们搞错了我的工资，我需要重新确认	我工资错了	我工资错了	我工资错了
我8月份的薪资一定给我算少了	我工资错了	这工资有问题吧	我工资错了
工资发的不正确	我工资错了	工资发的不对吧	我工资错了
如果薪资算错了，找那个部门啊	我工资错了	这工资有问题吧	我工资错了
我工资有问题，请问要找谁处理啊	我工资错了	工资怎么看	我要查工资
请帮我确认下工资，谢谢	我工资错了	怎么看工资	我要查工资
我上个月的工资发的有问题	我工资错了	工资发的好像有问题	我工资错了
我这个月的薪水发的有问题哎	我工资错了	这工资有问题吧	我工资错了
公司乒乓球qq群是多少	我要打兵乓球	我想加入篮球俱乐部	我要打篮球
帮我看看今天下午公司有没有人一起打乒乓球的	我要打兵乓球	公司可以组织一次乒乓球比赛吗	我要打兵乓球
我想看看公司最近的乒乓球比赛是几月几号	我要打兵乓球	公司可以组织一次乒乓球比赛吗	我要打兵乓球
公司有乒乓球俱乐部吗	我要打兵乓球	公司乒乓球队训练安排	我要打兵乓球
我要打兵乓球	我要打兵乓球	我要打兵乓球	我要打兵乓球
打乒乓球的人多吗	我要打兵乓球	我们公司平时有哪些人喜欢打乒乓球	我要打兵乓球
我可以报名公司下个月的乒乓球比赛吗	我要打兵乓球	公司可以组织一次乒乓球比赛吗	我要打兵乓球
下班了我们可以去哪里打乒乓球啊	我要打兵乓球	我们公司平时有哪些人喜欢打乒乓球	我要打兵乓球
今天下班了有人一起打乒乓球吗	我要打兵乓球	我们公司平时有哪些人喜欢打乒乓球	我要打兵乓球
契约锁都有哪些场景的案例？	在哪里可以查看到契约锁案例？	在哪里可以查看到契约锁案例？	在哪里可以查看到契约锁案例？
契约锁有金融行业相关案例吗	在哪里可以查看到契约锁案例？	契约锁都有哪些案例实践？	在哪里可以查看到契约锁案例？
契约锁案例包装找谁咨询？	在哪里可以查看到契约锁案例？	在哪里可以查看到契约锁案例？	在哪里可以查看到契约锁案例？
契约锁做过哪些行业的客户案例？	在哪里可以查看到契约锁案例？	契约锁做过哪些行业的客户？	契约锁做过哪些行业的客户？
契约锁案例包装找谁？	在哪里可以查看到契约锁案例？	在哪里可以查看到契约锁案例？	在哪里可以查看到契约锁案例？
契约锁案例找谁提供？	在哪里可以查看到契约锁案例？	在哪里可以查看到契约锁案例？	在哪里可以查看到契约锁案例？
契约锁有相关行业的案例吗？	在哪里可以查看到契约锁案例？	在哪里可以查看到契约锁案例？	在哪里可以查看到契约锁案例？
谁负责宕机问题?	系统宕机了找谁?	我的系统宕机了	系统宕机了找谁?
系统出现性能问题了	系统宕机了找谁?	系统宕机了找谁?	系统宕机了找谁?
系统dang机了怎么办?	系统宕机了找谁?	系统宕机了找谁?	系统宕机了找谁?
性能问题找谁?	系统宕机了找谁?	请问正式系统更新联系谁？	正式系统的需要做出调整应该找谁处理？
系统速度慢找谁?	系统宕机了找谁?	系统宕机了找谁?	系统宕机了找谁?
系统宕机了怎么办?	系统宕机了找谁?	系统宕机了找谁?	系统宕机了找谁?
系统当机了该找谁?	系统宕机了找谁?	我的系统宕机了	系统宕机了找谁?
我下周就要离开公司了，帮我办理一下离职手续吧	我要离职	给我办理离职	我要离职
这个职位跟我想的不太一样，我想辞职	我要离职	给我办理离职	我要离职
我现在就想辞职了	我要离职	我要辞职啊 	我要离职
你好，帮我办一下离职手续	我要离职	给我办理离职	我要离职
不好意思，我要申请离职	我要离职	我要离职，因为一些个人原因	我要离职
我要离职	我要离职	我要离职	我要离职
小e，我想离职	我要离职	我要离职	我要离职
我觉得这份工作不太适合我，因此想离职	我要离职	我要离职，因为一些个人原因	我要离职
我的收入证明上的收入金额好像不太对啊	我要开收入证明	可以麻烦你帮我开一个收入证明吗	我要开收入证明
帮我开一个收入证明	我要开收入证明	可以麻烦你帮我开一个收入证明吗	我要开收入证明
我的收入证明需要你在上面盖一个公司公章	我要开收入证明	我要开收入证明	我要开收入证明
我打算去日本旅游，但是公司能给我开个收入证明吗	我要开收入证明	可以麻烦你帮我开一个收入证明吗	我要开收入证明
收入证明需要我准备哪些材料啊	我要开收入证明	我要开收入证明	我要开收入证明
我要开收入证明	我要开收入证明	我要开收入证明	我要开收入证明
我的收入证明你可以帮我盖个章吗	我要开收入证明	我要开收入证明	我要开收入证明
我准备办理去日本的签证，公司这边可以帮我开个收入证明吗	我要开收入证明	可以麻烦你帮我开一个收入证明吗	我要开收入证明
发奖金了没	我要查奖金	我要查奖金	我要查奖金
看一下奖金	我要查奖金	我要查奖金	我要查奖金
奖金怎么看啊	我要查奖金	在哪里查看奖金	我要查奖金
我要查奖金	我要查奖金	我要查奖金	我要查奖金
看一下年终奖金	我要查奖金	帮我查一下，这个月发的奖金不够	我奖金错了
我项目奖金帮我看下	我要查奖金	我要查奖金	我要查奖金
看下我的奖金发了没	我要查奖金	我要查奖金	我要查奖金
我奖金发了多少	我要查奖金	我要查奖金	我要查奖金
如何看奖金	我要查奖金	在哪里查看奖金	我要查奖金
e-office成功客户案例找谁咨询？	想知道e-office的成功客户案例	哪里有e-office成功客户案例？	想知道e-office的成功客户案例
想知道e-office的成功客户案例	想知道e-office的成功客户案例	想知道e-office的成功客户案例	想知道e-office的成功客户案例
请问e-office成功客户案例去哪里找？	想知道e-office的成功客户案例	哪里有e-office成功客户案例？	想知道e-office的成功客户案例
e-office成功客户案例有吗？	想知道e-office的成功客户案例	哪里有e-office成功客户案例？	想知道e-office的成功客户案例
e-office成功客户案例谁有？	想知道e-office的成功客户案例	哪里有e-office成功客户案例？	想知道e-office的成功客户案例
申请一下，我要发起表扬	我要表扬	怎么申请表扬，我想表扬同事	我要表扬
表扬认真工作的开发人员	我要表扬	怎么申请表扬，我想表扬同事	我要表扬
我要表扬一下同事	我要表扬	怎么申请表扬，我想表扬同事	我要表扬
移动部的同事帮我们解决了大问题，我想表扬他	我要表扬	我周末没事干，可以给我申请一下来公司值班吗	我周末报名值班
请帮我发起表扬	我要表扬	请让我去北京工作	我要换城市
表扬信怎么提？	我要表扬	怎么申请表扬，我想表扬同事	我要表扬
他这个项目做得非常完美，值得表扬	我要表扬	请让我去北京工作	我要换城市
李林工作认真负责，应该表扬	我要表扬	我周末没事干，可以给我申请一下来公司值班吗	我周末报名值班
我申请表扬我们组的开发	我要表扬	怎么申请表扬，我想表扬同事	我要表扬
正式系统升级找谁？	正式系统的需要做出调整应该找谁处理？	我想给客户升级找谁	版本升级相关问题
正式系统更新找谁？	正式系统的需要做出调整应该找谁处理？	请问正式系统更新联系谁？	正式系统的需要做出调整应该找谁处理？
正式系统的需要做出调整应该找谁处理？	正式系统的需要做出调整应该找谁处理？	正式系统的需要做出调整应该找谁处理？	正式系统的需要做出调整应该找谁处理？
已收款未结算是什么意思？	已收款未结算是什么情况？	已收款未结算是什么情况？	已收款未结算是什么情况？
收款和结算的差别在哪里？	已收款未结算是什么情况？	收款和结算的区别是什么？	已收款未结算是什么情况？
为什么会显示已收款未结算？	已收款未结算是什么情况？	已收款未结算是什么情况？	已收款未结算是什么情况？
收款和结算有什么区别吗？	已收款未结算是什么情况？	收款和结算的区别是什么？	已收款未结算是什么情况？
已经收款但是没有结算？	已收款未结算是什么情况？	已收款未结算是什么情况？	已收款未结算是什么情况？
为什么系统说已收款未结算？	已收款未结算是什么情况？	已收款未结算是什么情况？	已收款未结算是什么情况？
已收款未结算是怎么回事？	已收款未结算是什么情况？	已收款未结算是什么情况？	已收款未结算是什么情况？
已收款未结算是什么原因？	已收款未结算是什么情况？	已收款未结算是什么情况？	已收款未结算是什么情况？
怎么策划和宣传市场活动？	我要办一个市场活动，但是以前从没有办过或参加过，我应该向谁咨询	我要办一个市场活动，但是以前从没有办过或参加过，我应该向谁咨询	我要办一个市场活动，但是以前从没有办过或参加过，我应该向谁咨询
市场活动策划找谁咨询？	我要办一个市场活动，但是以前从没有办过或参加过，我应该向谁咨询	请问市场活动设计物料支持，应该找谁，走什么流程	请问市场活动设计物料支持，应该找谁，走什么流程
市场活动举办向谁了解？	我要办一个市场活动，但是以前从没有办过或参加过，我应该向谁咨询	举办市场活动联系谁？	我要办一个市场活动，但是以前从没有办过或参加过，我应该向谁咨询
怎么办市场活动？	我要办一个市场活动，但是以前从没有办过或参加过，我应该向谁咨询	举办市场活动联系谁？	我要办一个市场活动，但是以前从没有办过或参加过，我应该向谁咨询
谁对办活动比较熟悉？	我要办一个市场活动，但是以前从没有办过或参加过，我应该向谁咨询	公司的活动安排找谁解决	公司的活动安排找谁解决
系统多语言相关问题	系统多语言相关问题	系统多语言相关问题	系统多语言相关问题
系统是否支持韩语	系统多语言相关问题	系统是否支持小语种	系统多语言相关问题
是否支持越南语	系统多语言相关问题	到哪里招人	我要发布招聘信息
我们系统支不支持日语	系统多语言相关问题	系统多语言相关问题	系统多语言相关问题
为什么小语种只支持oracle的数据库	系统多语言相关问题	我们3万人用，数据库服务器你们建议oracle还是sql?	我们支持哪几种国产数据库
哪里可以找到webservice文档	最新的webservice文档	最新的webservice文档能发给我一下吗？	最新的webservice文档
最新的webservice文档	最新的webservice文档	最新的webservice文档	最新的webservice文档
我想要最新的webservice文档	最新的webservice文档	最新的webservice文档能发给我一下吗？	最新的webservice文档
系统中毒怎么办？	系统中病毒了找谁	系统中毒怎么应急？	系统中病毒了找谁
处理病毒的安全专家？	系统中病毒了找谁	客户怎么防范勒索病毒？	客户中了勒索病毒找谁
系统中病毒了找谁	系统中病毒了找谁	系统中病毒了找谁	系统中病毒了找谁
我的系统中毒了	系统中病毒了找谁	系统中毒怎么应急？	系统中病毒了找谁
系统中毒，服务器被黑了	系统中病毒了找谁	系统宕机了找谁?	系统宕机了找谁?
系统受到攻击怎么解决？	系统中病毒了找谁	系统中毒怎么应急？	系统中病毒了找谁
系统怎么防范病毒？	系统中病毒了找谁	计算机病毒怎么处理？	系统中病毒了找谁
云商店界面显示异常问题	云商店显示异常问题	云商店显示异常问题	云商店显示异常问题
云商店界面存在显示异常现象怎么办	云商店显示异常问题	云商店显示异常问题	云商店显示异常问题
云商店显示异常问题	云商店显示异常问题	云商店显示异常问题	云商店显示异常问题
我签约了新客户或进行了一项活动，要宣传，找谁	我签约了新客户或进行了一项活动，要宣传，找谁	我签约了新客户或进行了一项活动，要宣传，找谁	我签约了新客户或进行了一项活动，要宣传，找谁
新客户宣传相关问题找谁咨询？	我签约了新客户或进行了一项活动，要宣传，找谁	我有很好的市场推广建议,该告诉谁来做宣传	我有很好的市场推广建议,该告诉谁来做宣传
活动宣传相关问题可以咨询谁？	我签约了新客户或进行了一项活动，要宣传，找谁	活动宣传找谁咨询？	我签约了新客户或进行了一项活动，要宣传，找谁
公司谁负责活动宣传相关事宜？	我签约了新客户或进行了一项活动，要宣传，找谁	活动宣传找谁咨询？	我签约了新客户或进行了一项活动，要宣传，找谁
新客户宣传的事情应该找谁了解？	我签约了新客户或进行了一项活动，要宣传，找谁	我有很好的市场推广建议,该告诉谁来做宣传	我有很好的市场推广建议,该告诉谁来做宣传
公司logo文件如何提供？	我想查找泛微logo文件	我想查找泛微logo文件	我想查找泛微logo文件
我想查找泛微logo文件	我想查找泛微logo文件	我想查找泛微logo文件	我想查找泛微logo文件
公司logo文件找谁要？	我想查找泛微logo文件	我想查找泛微logo文件	我想查找泛微logo文件
要投标人员劳动合同	要投标人员劳动合同	要投标人员劳动合同	要投标人员劳动合同
请立刻把投标人员劳动合同发我	要投标人员劳动合同	请发我一份投标人员劳动合同	要投标人员劳动合同
投标人员的劳动合同好了的话发我	要投标人员劳动合同	投标人员劳动合同有吗，有的话给我	要投标人员劳动合同
可以发我投标人员劳动合同吗	要投标人员劳动合同	要投标人员劳动合同	要投标人员劳动合同
哪里可以找到投标人员劳动合同	要投标人员劳动合同	请发我一份投标人员劳动合同	要投标人员劳动合同
给我一份投标人员劳动合同	要投标人员劳动合同	请发我一份投标人员劳动合同	要投标人员劳动合同
投标人员劳动合同请给我	要投标人员劳动合同	投标人员劳动合同有吗，有的话给我	要投标人员劳动合同
我需要投标人员的劳动合同	要投标人员劳动合同	请发我一份投标人员劳动合同	要投标人员劳动合同
他们和我说我们组被重组了？	组织架构变更？	帮我打开7月份的货	特殊-其他
我要调整公司的组织架构，现在的组织管理存在漏洞	组织架构变更？	你知道怎么调整部门的组织架构吗	组织架构变更？
怎么调整公司的组织架构，我想调整	组织架构变更？	你知道怎么调整部门的组织架构吗	组织架构变更？
公司的组织架构怎么更改	组织架构变更？	我们部门要改变组织结构了吗	组织架构变更？
我们公司的组织架构有点不太合理，请调整一下	组织架构变更？	小e，我要稍微调一下部门的组织架构，要找谁	组织架构变更？
我想调整组织架构	组织架构变更？	我想看组织架构图	我想要组织架构图
这样的组织不适合，我要调整一下本部门的组织架构	组织架构变更？	我们部门要改变组织结构了吗	组织架构变更？
目前公司的组织存在混乱，我希望对此进行初步调整	组织架构变更？	我觉得我们部门的组织架构有点混乱，想调整一下	组织架构变更？
我想稍微调整一下部门的组织架构	组织架构变更？	小e，我要稍微调一下部门的组织架构，要找谁	组织架构变更？
部门更改组织架构	组织架构变更？	我们部门要改变组织结构了吗	组织架构变更？
1组和2组合并了？	组织架构变更？	抄送功能	特殊-其他
两个组合并之后框架会变得	组织架构变更？	字段联动，有问题找谁？	字段联动，有问题找谁？
更改一下部门的组织框架	组织架构变更？	我们部门要改变组织结构了吗	组织架构变更？
我们组的项目改了负责人变了	组织架构变更？	我要离职，因为一些个人原因	我要离职
请帮我申请一下，我要投诉客户部的李林	我要投诉	给我投诉万达的客户负责人	我要投诉
客户服务态度太差，应该投诉他	我要投诉	给我投诉万达的客户负责人	我要投诉
我能投诉吗？你们的速度太慢了	我要投诉	成功客户投诉联系谁？	已经成功交付的客户有投诉找谁
小e，我要投诉客服，太差劲了	我要投诉	给我投诉万达的客户负责人	我要投诉
因为他的疏忽导致出了大错误，我必须投诉他	我要投诉	我的系统里信息好像显示的不对，小e你现在可以就帮我改改吗	我想更换系统信息
我要投诉	我要投诉	我要投诉	我要投诉
我很生气，我要投诉	我要投诉	我要投诉，这个项目糟透了	我要投诉
客户那边出问题了，我要投诉负责人	我要投诉	客户投诉怎么处理	实施过程中的客户投诉怎么处理
移动建模产品如何提交项目需求开发申请？	移动建模产品咨询，配置，需求相关问题？	移动建模产品如何提交项目bug？	移动建模产品如何提交项目bug？
如何在移动建模中添加脚本？	移动建模产品咨询，配置，需求相关问题？	能否简单说明一下我们怎么操作移动建模工具？	移动建模产品咨询，配置，需求相关问题？
移动建模的应用如何发布到手机端emobile	移动建模产品咨询，配置，需求相关问题？	移动建模的应用如何发布到手机微信中	移动建模产品咨询，配置，需求相关问题？
是不是有了移动建模就可以随意发布功能到手机上？	移动建模产品咨询，配置，需求相关问题？	是不是有了移动建模我就可以随意发布功能到手机上？	移动建模产品咨询，配置，需求相关问题？
移动建模产品咨询，配置，需求相关问题？	移动建模产品咨询，配置，需求相关问题？	移动建模产品咨询，配置，需求相关问题？	移动建模产品咨询，配置，需求相关问题？
什么是移动建模？	移动建模产品咨询，配置，需求相关问题？	移动建模的相关数据和功能哪里来呢	移动建模产品咨询，配置，需求相关问题？
移动建模的应用是否可以在第三方app中打开	移动建模产品咨询，配置，需求相关问题？	移动建模的应用如何发布到手机微信中	移动建模产品咨询，配置，需求相关问题？
移动建模文档在手机上点击没反应，无法打开是怎么回事？	移动建模产品咨询，配置，需求相关问题？	你们移动建模和业务建模是什么关系？	移动建模产品咨询，配置，需求相关问题？
表单建模和移动建模产品如何提交项目bug、需求开发申请？	移动建模产品咨询，配置，需求相关问题？	表单建模/移动建模产品如何提交项目bug、需求开发申请	表单建模/移动建模产品如何提交项目bug、需求开发申请
移动建模lbs控件无法获得当前地址是为何	移动建模产品咨询，配置，需求相关问题？	移动建模产品咨询，配置，需求相关问题？	移动建模产品咨询，配置，需求相关问题？
移动建模和业务建模是什么关系	移动建模产品咨询，配置，需求相关问题？	你们移动建模和业务建模是什么关系？	移动建模产品咨询，配置，需求相关问题？
移动建模中如何扫描二维码	移动建模产品咨询，配置，需求相关问题？	移动建模产品咨询，配置，需求相关问题？	移动建模产品咨询，配置，需求相关问题？
移动建模图表控件sql能否传参数？	移动建模产品咨询，配置，需求相关问题？	移动建模产品咨询，配置，需求相关问题？	移动建模产品咨询，配置，需求相关问题？
移动建模二次开发需求是否可以实现	移动建模产品咨询，配置，需求相关问题？	你们移动建模和业务建模是什么关系？	移动建模产品咨询，配置，需求相关问题？
移动建模中sql执行不了如何处理	移动建模产品咨询，配置，需求相关问题？	移动建模产品咨询，配置，需求相关问题？	移动建模产品咨询，配置，需求相关问题？
移动建模现成的应用案例哪里去找	移动建模产品咨询，配置，需求相关问题？	移动建模的相关数据和功能哪里来呢	移动建模产品咨询，配置，需求相关问题？
怎么操作移动建模工具？	移动建模产品咨询，配置，需求相关问题？	能否简单说明一下我们怎么操作移动建模工具？	移动建模产品咨询，配置，需求相关问题？
外部用户如何通过扫码访问移动建模的页面	移动建模产品咨询，配置，需求相关问题？	能否简单说明一下我们怎么操作移动建模工具？	移动建模产品咨询，配置，需求相关问题？
如何在移动建模中添加样式代码？	移动建模产品咨询，配置，需求相关问题？	能否简单说明一下我们怎么操作移动建模工具？	移动建模产品咨询，配置，需求相关问题？
e-office新增了哪些功能？	我怎么知道e-office系统有哪些新功能	我怎么知道e-office系统有哪些新功能	我怎么知道e-office系统有哪些新功能
怎么查询e-office新增功能？	我怎么知道e-office系统有哪些新功能	e-office新功能怎么查询？	我怎么知道e-office系统有哪些新功能
我怎么知道e-office系统有哪些新功能	我怎么知道e-office系统有哪些新功能	我怎么知道e-office系统有哪些新功能	我怎么知道e-office系统有哪些新功能
在哪里可以查看e-office新增功能？	我怎么知道e-office系统有哪些新功能	我怎么知道e-office系统有哪些新功能	我怎么知道e-office系统有哪些新功能
e-office系统新功能有哪些？	我怎么知道e-office系统有哪些新功能	我怎么知道e-office系统有哪些新功能	我怎么知道e-office系统有哪些新功能
我准备办理护照，需要开一个在职证明	我要开在职证明	在职证明需要办理什么手续吗	我要开在职证明
我上周刚来公司上班可以给我开一个在职证明吗	我要开在职证明	我要开在职证明	我要开在职证明
在职证明需要我本人签字吗	我要开在职证明	我要开在职证明	我要开在职证明
我来公司实习三个月了可以开在职证明吗	我要开在职证明	我下个月要准备出国度蜜月可以帮我开一个在职证明吗	我要开在职证明
我该找谁开在职证明啊	我要开在职证明	我要开在职证明	我要开在职证明
我要开在职证明	我要开在职证明	我要开在职证明	我要开在职证明
公司在职证明怎么开啊	我要开在职证明	在职证明需要办理什么手续吗	我要开在职证明
我今天来公司需要开一个在职证明	我要开在职证明	我要开在职证明	我要开在职证明
项目验收核算问题找谁？	项目验收核算问题找谁？	项目验收核算问题找谁？	项目验收核算问题找谁？
项目验收能否核算	项目验收核算问题找谁？	项目验收核算问题找谁？	项目验收核算问题找谁？
客户要查看历史验收报告找谁？	项目验收核算问题找谁？	项目验收报告怎么处理	项目验收核算问题找谁？
向谁提出项目验收？	项目验收核算问题找谁？	项目验收核算问题找谁？	项目验收核算问题找谁？
需要看历史验收报告	项目验收核算问题找谁？	项目验收报告怎么处理	项目验收核算问题找谁？
项目中对功能有疑问怎么办？	在项目中，有些功能不理解该怎么办	项目中对功能有疑问找谁协助？	在项目中，有些功能不理解该怎么办
在项目中，有些功能不理解该怎么办	在项目中，有些功能不理解该怎么办	在项目中，有些功能不理解该怎么办	在项目中，有些功能不理解该怎么办
项目功能有疑问应该如何处理？	在项目中，有些功能不理解该怎么办	项目中对功能有疑问找谁协助？	在项目中，有些功能不理解该怎么办
项目中对功能不理解怎么办？	在项目中，有些功能不理解该怎么办	在项目中，有些功能不理解该怎么办	在项目中，有些功能不理解该怎么办
项目中对功能有不理解的地方找谁咨询？	在项目中，有些功能不理解该怎么办	项目中对功能有疑问找谁协助？	在项目中，有些功能不理解该怎么办
收款未结算表中的未立项是什么意思？	在收款未结算表中写未立项是什么情况？	收款未结算表中的未立项是指什么？	在收款未结算表中写未立项是什么情况？
为什么在收款未结算表中标记为未立项？	在收款未结算表中写未立项是什么情况？	收款未结算表中写未立项是因为什么？	在收款未结算表中写未立项是什么情况？
为什么在收款未结算表中还有未立项这一项？	在收款未结算表中写未立项是什么情况？	在收款未结算表中写未立项是什么情况？	在收款未结算表中写未立项是什么情况？
收款未结算表中的未立项说明什么？	在收款未结算表中写未立项是什么情况？	收款未结算表中的未立项是指什么？	在收款未结算表中写未立项是什么情况？
收款未结算表中的未立项意味着什么？	在收款未结算表中写未立项是什么情况？	收款未结算表中的未立项是指什么？	在收款未结算表中写未立项是什么情况？
收款未结算表中写未立项是什么原因？	在收款未结算表中写未立项是什么情况？	收款未结算表中写未立项是因为什么？	在收款未结算表中写未立项是什么情况？
为什么在收款未结算表中有未立项的说明？	在收款未结算表中写未立项是什么情况？	收款未结算表中写未立项是因为什么？	在收款未结算表中写未立项是什么情况？
为什么在收款未结算表中显示未立项？	在收款未结算表中写未立项是什么情况？	在收款未结算表中写未立项是什么情况？	在收款未结算表中写未立项是什么情况？
办理我的资信证明	资信证明如何办理	资信证明如何办理	资信证明如何办理
我要申请办理资信证明	资信证明如何办理	资信证明如何办理	资信证明如何办理
资信证明如何办理	资信证明如何办理	资信证明如何办理	资信证明如何办理
公司可以办理资信证明吗	资信证明如何办理	资信证明如何办理	资信证明如何办理
办理信贷要哪些资料	资信证明如何办理	湖南三正电子的资料我可以申领查看吗	公司资料申请
资信证明在哪开	资信证明如何办理	资信证明如何办理	资信证明如何办理
我想要资信证明	资信证明如何办理	资信证明如何办理	资信证明如何办理
我要开资信证明	资信证明如何办理	资信证明如何办理	资信证明如何办理
我没有带key，怎么进系统啊	我忘带key了	没带key，找谁解决啊	我忘带key了
我没想起来要带key，怎么办啊	我忘带key了	没带key，找谁解决啊	我忘带key了
我把key落在家里了	我忘带key了	我忘带key了	我忘带key了
我没有带key	我忘带key了	没带key，找谁解决啊	我忘带key了
今天没有带key哎	我忘带key了	我忘带key了	我忘带key了
我忘记带key严重吗，怎么办啊	我忘带key了	没带key，找谁解决啊	我忘带key了
忘带key怎么办	我忘带key了	没带key，找谁解决啊	我忘带key了
我忘带key了	我忘带key了	我忘带key了	我忘带key了
我的报销标准是多少	我想知道报销标准	我想知道报销标准	我想知道报销标准
我们部门准备出去旅游，我们的报销标准是多少	我想知道报销标准	我明天要准备去北京，我的报销有标准吗	出差报销标准
我们部门的报销标准是多少	我想知道报销标准	我想知道报销标准	我想知道报销标准
我来公司已经两年了，为什么我的报销标注还是1000	我想知道报销标准	为什么我的报销标准只有1000块	我想知道报销标准
我想知道报销标准	我想知道报销标准	我想知道报销标准	我想知道报销标准
我这个月的报销额度和标准是什么	我想知道报销标准	为什么我的报销标准只有1000块	我想知道报销标准
餐费报销制度找谁咨询？	我想知道报销标准	费用报销的反馈信息	费用报销的周期
餐费报销标准	我想知道报销标准	我陪客户一起吃饭的钱可以报销吗，有什么标准吗	我想知道报销标准
我想查一下餐费报销制度	我想知道报销标准	费用报销的反馈信息	费用报销的周期
你可以告诉我报销标准吗	我想知道报销标准	我想知道报销标准	我想知道报销标准
新客户的需办理合同怎么还没到？	新客户寄来需办理的合同收到了吗？	谁负责接收新客户寄来的需办理合同	新客户寄来需办理的合同收到了吗？
新客户寄来的需办理合同是谁签收的？	新客户寄来需办理的合同收到了吗？	谁负责接收新客户寄来的需办理合同	新客户寄来需办理的合同收到了吗？
怎么查询新客户寄来的需办理合同是否到件	新客户寄来需办理的合同收到了吗？	谁负责接收新客户寄来的需办理合同	新客户寄来需办理的合同收到了吗？
有位新客户需办理的合同帮我盖章邮寄一下	新客户寄来需办理的合同收到了吗？	新客户的需办理的合同盖章要找谁？	新客户寄来需办理的合同收到了吗？
新客户寄来的需办理的合同收到了吗？	新客户寄来需办理的合同收到了吗？	新客户寄来需办理的合同收到了吗？	新客户寄来需办理的合同收到了吗？
新客户的需办理的合同寄过来了吗？	新客户寄来需办理的合同收到了吗？	谁负责接收新客户寄来的需办理合同	新客户寄来需办理的合同收到了吗？
新客户寄来需办理的合同收到了吗？	新客户寄来需办理的合同收到了吗？	新客户寄来需办理的合同收到了吗？	新客户寄来需办理的合同收到了吗？
帮我找一个新客户寄来的需办理合同	新客户寄来需办理的合同收到了吗？	谁负责接收新客户寄来的需办理合同	新客户寄来需办理的合同收到了吗？
投标人员的简历好了的话发我	要投标人员简历	投标人员简历请给我	要投标人员简历
我现在急需投标人员简历	要投标人员简历	我需要投标人员的简历	要投标人员简历
请发我一份投标人员简历	要投标人员简历	哪里可以找到投标人员简历	要投标人员简历
给我一份投标人员简历	要投标人员简历	哪里可以找到投标人员简历	要投标人员简历
要投标人员简历	要投标人员简历	要投标人员简历	要投标人员简历
投标人员简历有吗，有的话给我	要投标人员简历	投标人员简历请给我	要投标人员简历
请立刻把投标人员简历发我	要投标人员简历	哪里可以找到投标人员简历	要投标人员简历
可以发我投标人员简历吗	要投标人员简历	要投标人员简历	要投标人员简历
有移动建模引擎功能相关的介绍吗	移动建模引擎功能白皮书有吗	移动建模引擎功能白皮书有吗	移动建模引擎功能白皮书有吗
解释下移动建模引擎	移动建模引擎功能白皮书有吗	能否简单说明一下我们怎么操作移动建模工具？	移动建模产品咨询，配置，需求相关问题？
移动建模引擎功能的有关说明	移动建模引擎功能白皮书有吗	移动建模引擎功能白皮书有吗	移动建模引擎功能白皮书有吗
我想咨询下移动建模引擎功能相关的问题	移动建模引擎功能白皮书有吗	移动建模引擎功能白皮书有吗	移动建模引擎功能白皮书有吗
我们压测的注册用户数、在线用户数、并发用户数是怎么换算的	压测相关问题	复星集团向我们申请增加用户数	licence客户用户数不够用，可以多申请吗？
压测相关问题	压测相关问题	压测相关问题	压测相关问题
我们有压测的接口文档吗	压测相关问题	我们有5000并发以上的压测报告吗	我们有ecology8.0的压测报告吗
我们有压力测试软件使用教程吗	压测相关问题	压力测试前需要做什么准备工作	压测相关问题
我们用什么软件进行压测	压测相关问题	压测相关问题	压测相关问题
公司对自己员工结婚这块有什么福利吗	我要领结婚礼物	公司对员工结婚会提供哪些福利啊	我要领结婚礼物
公司会给我什么样的结婚礼物啊	我要领结婚礼物	自己员工结婚公司会送什么啊	我要领结婚礼物
我想看看我的结婚礼物是什么	我要领结婚礼物	我要领结婚礼物	我要领结婚礼物
我要领结婚礼物	我要领结婚礼物	我要领结婚礼物	我要领结婚礼物
我打算明年结婚了，到时候公司可以给我什么优惠券什么的吗	我要领结婚礼物	今年我准备结婚，公司会有什么福利吗	我要领结婚礼物
我下周就结婚了，公司有什么礼物赠送的吗	我要领结婚礼物	自己员工结婚公司会送什么啊	我要领结婚礼物
对于结婚这块，咱们公司有对应的礼物或者福利吗	我要领结婚礼物	今年我准备结婚，公司会有什么福利吗	我要领结婚礼物
我今年准备结婚，公司有什么相对应的员工福利吗	我要领结婚礼物	今年我准备结婚，公司会有什么福利吗	我要领结婚礼物
谁有新客户合同模板	新客户合同模版在哪里？	我想要新客户合同模板找谁	新客户合同模版在哪里？
你知道哪有新客户合同模板吗	新客户合同模版在哪里？	我想要新客户合同模板找谁	新客户合同模版在哪里？
新客户合同模板找谁要	新客户合同模版在哪里？	我想要新客户合同模板找谁	新客户合同模版在哪里？
我需要一份新客户合同模板去哪里找	新客户合同模版在哪里？	我想要新客户合同模板找谁	新客户合同模版在哪里？
哪里能下载新客户合同模板	新客户合同模版在哪里？	我想要新客户合同模板找谁	新客户合同模版在哪里？
请给我一份新客户合同模板	新客户合同模版在哪里？	我想要新客户合同模板找谁	新客户合同模版在哪里？
新客户合同模板怎么下载	新客户合同模版在哪里？	我想要新客户合同模板找谁	新客户合同模版在哪里？
哪里找新客户合同模板	新客户合同模版在哪里？	我想要新客户合同模板找谁	新客户合同模版在哪里？
近期的客户培训活动是什么时候？	有客户需要参加培训，我该找谁来处理	我想查询最近的客户培训活动找谁？	有客户需要参加培训，我该找谁来处理
客户要参加培训联系谁？	有客户需要参加培训，我该找谁来处理	有客户需要参加培训，我该找谁来处理	有客户需要参加培训，我该找谁来处理
客户要参加产品培训找谁咨询？	有客户需要参加培训，我该找谁来处理	有客户需要参加培训，我该找谁来处理	有客户需要参加培训，我该找谁来处理
有客户需要参加培训，我该找谁来处理	有客户需要参加培训，我该找谁来处理	有客户需要参加培训，我该找谁来处理	有客户需要参加培训，我该找谁来处理
客户培训活动安排找谁咨询？	有客户需要参加培训，我该找谁来处理	我想查询最近的客户培训活动找谁？	有客户需要参加培训，我该找谁来处理
e8能在国产化终端下使用吗	我们支持哪些国产操作系统	我们支持哪些国产操作系统	我们支持哪些国产操作系统
我们支持哪些国产中间件	我们支持哪些国产操作系统	支持的国产中间件有哪些	支持的国产中间件有哪些
我们的系统平台支持申威cpu吗	我们支持哪些国产操作系统	我们有适配过arm的cpu环境吗	我们有适配过arm的cpu环境吗
我们支持哪些国产操作系统	我们支持哪些国产操作系统	我们支持哪些国产操作系统	我们支持哪些国产操作系统
支持麒麟操作系统吗	我们支持哪些国产操作系统	用户客户端使用麒麟系统访问ecology 我请教下谁	我们支持哪些国产操作系统
国产化服务器操作系统和中间件支持情况	我们支持哪些国产操作系统	国产化服务器操作系统支持情况	我们支持哪些国产操作系统
我们支持国产操作系统吗	我们支持哪些国产操作系统	我们支持哪些国产操作系统	我们支持哪些国产操作系统
e9支持什么国产的操作系统	我们支持哪些国产操作系统	我们支持哪些国产操作系统	我们支持哪些国产操作系统
e9支持linux系统安装吗	我们支持哪些国产操作系统	有e8升级e9推荐方案吗？	有e8升级e9推荐方案吗？
新员工考核有问题找谁咨询？	新员工考核咨询谁？	新员工考核咨询谁？	新员工考核咨询谁？
转正考试	新员工考核咨询谁？	我要转正需要准备什么	我要转正
新员工考核咨询谁？	新员工考核咨询谁？	新员工考核咨询谁？	新员工考核咨询谁？
新员工入职后怎么考核？	新员工考核咨询谁？	新员工考核咨询谁？	新员工考核咨询谁？
云桥如何集成微信	云桥怎么集成	云桥和钉钉、微信企业号、微信服务号怎么集成	云桥怎么集成
云桥和钉钉、微信企业号、微信服务号集成如何实现	云桥怎么集成	云桥和钉钉、微信企业号、微信服务号怎么集成	云桥怎么集成
云桥怎么集成	云桥怎么集成	云桥怎么集成	云桥怎么集成
云桥怎么集成微信	云桥怎么集成	云桥和钉钉、微信企业号、微信服务号怎么集成	云桥怎么集成
云桥如何集成第三方app	云桥怎么集成	云桥如何集成第三方app怎么办	云桥怎么集成
云桥怎么集成第三方app	云桥怎么集成	云桥如何集成第三方app怎么办	云桥怎么集成
目前有没有客户做过和企业微信集成的案例？	云桥怎么集成	企业微信集成	企业微信
emessage聊天信息推送给企业微信；云桥如何配置？	云桥怎么集成	云桥和钉钉、微信企业号、微信服务号怎么集成	云桥怎么集成
有关于集成钉钉的移动考勤方案吗？	云桥怎么集成	e9新考勤是否支持和钉钉集成同步。	e9新考勤是否支持和钉钉集成同步。
云桥和钉钉、微信企业号、微信服务号如何集成	云桥怎么集成	云桥和钉钉、微信企业号、微信服务号怎么集成	云桥怎么集成
钉钉系统是否可以和我们做集成	云桥怎么集成	钉钉集成接入配置	云桥怎么集成
你这边是否有云桥e-bridge文档资料	云桥怎么集成	咨询一下小e的架构	小e相关问题
message聊天信息推送给企业微信；该选择哪个推送模块？	云桥怎么集成	我要云桥和钉钉、微信企业号、微信服务号集成怎么搞	云桥怎么集成
云桥怎么样可以集成第三方app	云桥怎么集成	云桥如何集成第三方app怎么办	云桥怎么集成
有没有泛微云桥e-bridge 微信公众号的集成配置手册呀？	云桥怎么集成	云桥和钉钉、微信企业号、微信服务号怎么集成	云桥怎么集成
云桥能够集成的app有哪些？	云桥怎么集成	云桥咋弄集成第三方app	云桥怎么集成
能给我查看我的劳动合约吗	我要劳动合同	打开我的劳动合同	我要劳动合同
我来公司时签的合约可不可以给我看看	我要劳动合同	我签了新客户但是新闻上还没有呢？	我签约了新客户怎么没发新闻呢
劳动合同在哪里可以查看	我要劳动合同	我的劳动合同给我看一下	我要劳动合同
看一下我的劳动合同	我要劳动合同	我的劳动合同给我看一下	我要劳动合同
查看我的劳动合同	我要劳动合同	我的劳动合同给我看一下	我要劳动合同
找一下我的劳动合同，我想看看	我要劳动合同	我的劳动合同给我看一下	我要劳动合同
小e，我想查看一下我入职时签的合同	我要劳动合同	入职证明材料要什么	办理入职我要准备哪些材料
我要看一下入职的劳动合同	我要劳动合同	我的劳动合同给我看一下	我要劳动合同
为什么相邻节点不能自动穿透？	相邻节点不能自动穿透是什么原因？	相邻节点不能自动穿透是什么原因？	相邻节点不能自动穿透是什么原因？
相邻节点不能自动穿透找谁？	相邻节点不能自动穿透是什么原因？	相邻节点没有自动穿透找谁处理？	相邻节点不能自动穿透是什么原因？
相邻节点自动穿透失败是什么引起的？	相邻节点不能自动穿透是什么原因？	相邻节点不能自动穿透是什么原因？	相邻节点不能自动穿透是什么原因？
相邻节点无法自动穿透是因为什么？	相邻节点不能自动穿透是什么原因？	相邻节点不能自动穿透是什么原因？	相邻节点不能自动穿透是什么原因？
相邻节点不能自动穿透怎么解决？	相邻节点不能自动穿透是什么原因？	相邻节点没有自动穿透找谁处理？	相邻节点不能自动穿透是什么原因？
客户投诉相关问题找谁？	已经成功交付的客户有投诉找谁	客户投诉怎么处理	实施过程中的客户投诉怎么处理
已交付的客户投诉如何处理？	已经成功交付的客户有投诉找谁	实施过程中的客户投诉怎么处理	实施过程中的客户投诉怎么处理
客户投诉找谁咨询？	已经成功交付的客户有投诉找谁	客户投诉怎么处理	实施过程中的客户投诉怎么处理
成功客户投诉找谁？	已经成功交付的客户有投诉找谁	成功客户投诉联系谁？	已经成功交付的客户有投诉找谁
已经交付的客户投诉找谁协助？	已经成功交付的客户有投诉找谁	实施过程中的客户投诉找谁？	实施过程中的客户投诉怎么处理
我想知道请假制度	我想知道请假制度	我想知道请假制度	我想知道请假制度
请帮我找找看请假必须了解的制度规定	我想知道请假制度	我想知道请假制度	我想知道请假制度
请假的制度有哪些	我想知道请假制度	我想知道请假制度	我想知道请假制度
我们公司对请假有什么要求	我想知道请假制度	帮我查一下公司关于请假的相关规定	我想知道请假制度
我要查询关于请假的规章制度	我想知道请假制度	我想知道请假制度	我想知道请假制度
我想知道公司对请假有什么制度规定	我想知道请假制度	我想知道请假制度	我想知道请假制度
请假有什么规定吗	我想知道请假制度	帮我查一下公司关于请假的相关规定	我想知道请假制度
我们公司的请假制度是什么样子的，给我看一下	我想知道请假制度	帮我查一下公司关于请假的相关规定	我想知道请假制度
本地系统怎么获取安装盘？	我要在本机搭建一套系统，要怎么获得安装盘	搭建本地系统安装盘找谁要？	我要在本机搭建一套系统，要怎么获得安装盘
本地搭建系统怎么申请安装盘？	我要在本机搭建一套系统，要怎么获得安装盘	搭建本地系统安装盘找谁要？	我要在本机搭建一套系统，要怎么获得安装盘
本地系统需要安装盘找谁咨询？	我要在本机搭建一套系统，要怎么获得安装盘	搭建本地系统安装盘找谁要？	我要在本机搭建一套系统，要怎么获得安装盘
本地系统安装盘在哪里获取？	我要在本机搭建一套系统，要怎么获得安装盘	搭建本地系统安装盘找谁要？	我要在本机搭建一套系统，要怎么获得安装盘
获取安装盘搭建本地系统走什么流程？	我要在本机搭建一套系统，要怎么获得安装盘	搭建本地系统安装盘找谁要？	我要在本机搭建一套系统，要怎么获得安装盘
我们的正式系统流程需要调整一下	正式系统流程调整	正式系统流程调整	正式系统流程调整
正式系统流程怎么调整	正式系统流程调整	正式系统流程调整	正式系统流程调整
正式系统流程调整	正式系统流程调整	正式系统流程调整	正式系统流程调整
云桥配置流程要怎么整	云桥如何配置流程	云桥如何配置流程	云桥如何配置流程
云桥怎么配置流程	云桥如何配置流程	云桥如何配置流程	云桥如何配置流程
云桥配置流程怎么搞	云桥如何配置流程	云桥如何配置流程	云桥如何配置流程
云桥要怎么配置流程	云桥如何配置流程	云桥如何配置流程	云桥如何配置流程
昨天没有请假，考勤显示错误了	我考勤数据错了	昨天我没旷工，我请假了，考勤数据不对	我考勤数据错了
我系统里有一次旷工怎么处理啊，因为我周一生病没来上班忘记请假了	我考勤数据错了	前天忘记签到，系统记我旷工了怎么办	我考勤数据错了
如果缺勤，我该怎么做	我考勤数据错了	小e，我上周五没有迟到呀，考勤表上显示错误了	我考勤数据错了
因为请假显示的缺勤数据怎么办	我考勤数据错了	请告诉我如何处理系统里的缺勤数据	我考勤数据错了
如果旷工，怎么处理系统数据	我考勤数据错了	你知道如何处理系统里的旷工数据吗	我考勤数据错了
系统显示缺勤怎么办	我考勤数据错了	请告诉我如何处理系统里的缺勤数据	我考勤数据错了
你给我改一下，我这周一没有请假	我考勤数据错了	我想知道请假制度	我想知道请假制度
考勤表多算了我一天迟到，怎么改呀	我考勤数据错了	小e，我上周五没有迟到呀，考勤表上显示错误了	我考勤数据错了
请查询一下缺勤怎么办	我考勤数据错了	小e，我上周五没有迟到呀，考勤表上显示错误了	我考勤数据错了
系统显示我旷工好几天，怎么办	我考勤数据错了	系统宕机了找谁?	系统宕机了找谁?
忘记签到了	我考勤数据错了	忘记了会怎么样	特殊-其他
我昨天忘记签到，系统显示成旷工了，我该怎么办呀	我考勤数据错了	前天忘记签到，系统记我旷工了怎么办	我考勤数据错了
上周五我请病假了，系统记录为缺勤，该怎么处理	我考勤数据错了	我们公司规定请病假必备资料有哪些	病假要什么资料
昨天生病了没有来上班，怎么取消系统旷工	我考勤数据错了	前天忘记签到，系统记我旷工了怎么办	我考勤数据错了
看一下系统里我有缺勤吗，有的话怎么处理	我考勤数据错了	请告诉我如何处理系统里的缺勤数据	我考勤数据错了
系统显示我缺勤好几天，怎么办	我考勤数据错了	昨天没来上班，系统记我缺勤了一天，怎么办呀	我考勤数据错了
你帮我查一下系统显示旷工怎么办	我考勤数据错了	系统宕机了找谁?	系统宕机了找谁?
我出差是上周不是这周，考勤表显示的不对	我考勤数据错了	小e，我上周五没有迟到呀，考勤表上显示错误了	我考勤数据错了
怎么处理系统里的缺勤记录啊	我考勤数据错了	请告诉我如何处理系统里的缺勤数据	我考勤数据错了
小e，如果缺勤，怎么处理系统数据	我考勤数据错了	请告诉我如何处理系统里的缺勤数据	我考勤数据错了
忘记打卡了	我考勤数据错了	帮我买个卡。	特殊-其他
我早上按时签到了，考勤表错了	我考勤数据错了	小e，我上周五没有迟到呀，考勤表上显示错误了	我考勤数据错了
怎么处理系统里的旷工	我考勤数据错了	你知道如何处理系统里的旷工数据吗	我考勤数据错了
系统显示旷工怎么办	我考勤数据错了	系统宕机了找谁?	系统宕机了找谁?
我11月份有一天旷工，该怎么做	我考勤数据错了	前天忘记签到，系统记我旷工了怎么办	我考勤数据错了
我想申请领医保卡	我要领取医保卡	我要领取医保卡	我要领取医保卡
医保卡办好之后去哪里领取	我要领取医保卡	我想领一下我的医保卡	我要领取医保卡
你好，你知道医保卡去哪里领取吗	我要领取医保卡	我想领一下我的医保卡	我要领取医保卡
医保卡办好了怎么领啊	我要领取医保卡	我想领一下我的医保卡	我要领取医保卡
小e，帮我领一下医保卡	我要领取医保卡	我要领取医保卡	我要领取医保卡
医保卡如果办好了帮我领一下	我要领取医保卡	我想领一下我的医保卡	我要领取医保卡
我已经入职一个月了，医保卡办好了吗	我要领取医保卡	大概入职多久医保卡能够办好呀	我要领取医保卡
下周末我要报名来公司值班	我周末报名值班	我想周末来公司值班，帮我报个名	我周末报名值班
快给我报名，周末来公司值班	我周末报名值班	我想周末来公司值班，帮我报个名	我周末报名值班
你好，我要报名周末值班	我周末报名值班	我周末报名值班	我周末报名值班
我周末报名值班	我周末报名值班	我周末报名值班	我周末报名值班
我周末想来公司值班	我周末报名值班	我周末没事干，可以给我申请一下来公司值班吗	我周末报名值班
周末值班报名找谁呀，我要报一个	我周末报名值班	我周末报名值班	我周末报名值班
怎么申请周末值班，帮我报名	我周末报名值班	请打开周末值班申请	我周末报名值班
申请周末值班	我周末报名值班	我周末报名值班	我周末报名值班
可不可以发我总结报告模板	我要要个总结报告模板	我急需总结报告模板	我要要个总结报告模板
总结报告模板你那边有吗，发我一份	我要要个总结报告模板	总结报告模板请给我一份	我要要个总结报告模板
方便给我一个总结报告模板吗	我要要个总结报告模板	我要要个总结报告模板	我要要个总结报告模板
能给我一份总结报告模板吗	我要要个总结报告模板	我要要个总结报告模板	我要要个总结报告模板
请发我一份总结报告模板	我要要个总结报告模板	我要要个总结报告模板	我要要个总结报告模板
我想找个总结报告模板	我要要个总结报告模板	我要要个总结报告模板	我要要个总结报告模板
在哪里找总结报告模板	我要要个总结报告模板	总结报告模板请给我一份	我要要个总结报告模板
有总结报告模板吗，给我一份吧	我要要个总结报告模板	我要要个总结报告模板	我要要个总结报告模板
我能看到客户使用系统的频率吗？	我想了解客户的系统的使用情况，找谁来询问	我怎样可以了解到客户使用系统的情况？	我想了解客户的系统的使用情况，找谁来询问
我想了解客户的系统的使用情况，找谁来询问	我想了解客户的系统的使用情况，找谁来询问	我想了解客户的系统的使用情况，找谁来询问	我想了解客户的系统的使用情况，找谁来询问
如何查询客户的系统使用情况？	我想了解客户的系统的使用情况，找谁来询问	我想了解客户的系统的使用情况，找谁来询问	我想了解客户的系统的使用情况，找谁来询问
如何知道客户使用系统的情况？	我想了解客户的系统的使用情况，找谁来询问	我怎样可以了解到客户使用系统的情况？	我想了解客户的系统的使用情况，找谁来询问
客户系统用得怎么样？	我想了解客户的系统的使用情况，找谁来询问	客户的系统使用情况怎么了解？	我想了解客户的系统的使用情况，找谁来询问
客户使用系统的情况怎么查询？	我想了解客户的系统的使用情况，找谁来询问	我怎样可以了解到客户使用系统的情况？	我想了解客户的系统的使用情况，找谁来询问
早上吃的油条太硬了	用餐时间	我要放鞭炮	特殊-其他
吃饭找谁	用餐时间	我请青岛	特殊-其他
午饭时间	用餐时间	上周五下午5点半	特殊-其他
下午茶我们可以多放一些蛋糕	用餐时间	下午茶我要喝可乐	用餐时间
以后早餐的鸡蛋能不能多备份一些，不够吃	用餐时间	后天有十个客户要在公司吃饭	请通知行政部门，明天中午在公司的招待餐厅准备十人的用餐
早饭几点开始	用餐时间	午饭几点开始	用餐时间
公司的食堂饭菜不好吃	用餐时间	后天有十个客户要在公司吃饭	请通知行政部门，明天中午在公司的招待餐厅准备十人的用餐
早饭的馒头太大了	用餐时间	我上个月的电话费充一百块	特殊-其他
下午茶的饮料有哪些	用餐时间	下午茶我要喝可乐	用餐时间
晚饭时间	用餐时间	早饭时间	用餐时间
早餐有茶叶蛋吗	用餐时间	下午茶我要喝可乐	用餐时间
晚饭几点开始	用餐时间	早饭时间	用餐时间
早餐我想吃烧麦	用餐时间	早饭的粥好烫，有没有温热的	用餐时间
下午茶的西瓜挺甜的	用餐时间	早饭的粥好烫，有没有温热的	用餐时间
银行承兑汇票怎么核算业绩	银行承兑汇票如何核算业绩	银行承兑汇票可以核算业绩吗	银行承兑汇票如何核算业绩
银行承兑汇票如何核算业绩	银行承兑汇票如何核算业绩	银行承兑汇票如何核算业绩	银行承兑汇票如何核算业绩
支票付款会算在业绩里面吗	银行承兑汇票如何核算业绩	支票付款怎么算业绩	银行承兑汇票如何核算业绩
银行承兑汇票能否核算在业绩里	银行承兑汇票如何核算业绩	银行承兑汇票是否核算在业绩里	银行承兑汇票如何核算业绩
客户用支付宝转账怎么核算销售业绩	银行承兑汇票如何核算业绩	今年我签的全部合同在哪里查看？	当年合同业绩如何查询？
支票付款可以算在业绩里面吗	银行承兑汇票如何核算业绩	支票付款怎么算业绩	银行承兑汇票如何核算业绩
支票付款业绩要怎么算？	银行承兑汇票如何核算业绩	银行承兑汇票是否核算在业绩里	银行承兑汇票如何核算业绩
支票付款如何算业绩	银行承兑汇票如何核算业绩	支票付款怎么算业绩	银行承兑汇票如何核算业绩
我要开通邮箱	我要开通邮箱	我要开通邮箱	我要开通邮箱
可以帮我把公司邮箱开通吗	我要开通邮箱	请帮我尽快开通邮箱	我要开通邮箱
如何开通邮箱	我要开通邮箱	请帮我尽快开通邮箱	我要开通邮箱
请帮我开通邮箱	我要开通邮箱	我要开通邮箱	我要开通邮箱
请尽快为我开通办公邮箱	我要开通邮箱	请帮我尽快开通邮箱	我要开通邮箱
开通邮箱的步骤	我要开通邮箱	能帮我开一下邮箱功能吗	我要开通邮箱
怎么开通邮箱功能啊	我要开通邮箱	能帮我开一下邮箱功能吗	我要开通邮箱
邮箱	我要开通邮箱	设置邮箱	特殊-其他
我需要开通邮箱功能	我要开通邮箱	能帮我开一下邮箱功能吗	我要开通邮箱
邮箱初始密码	我要开通邮箱	修改密码要找系统管理员吗	如何修改密码？
我今天去银行办理业务要我提供一个工作证明	我要开工作证明	我要开工作证明	我要开工作证明
我来公司工作两年了可以开个工作证明吗	我要开工作证明	你好，我已经离职了还可以开工作证明吗	我要开工作证明
工作证明可以开几个月的啊	我要开工作证明	工作证明要多久可以拿到啊	我要开工作证明
我要开工作证明	我要开工作证明	我要开工作证明	我要开工作证明
请问工作证明怎么开啊	我要开工作证明	我要开工作证明	我要开工作证明
公司可以给我开一个工作证明吗，我要去银行办业务需要	我要开工作证明	我要开工作证明	我要开工作证明
公司有工作证明吗	我要开工作证明	我要开工作证明	我要开工作证明
工作证明应该找公司的谁啊	我要开工作证明	我要开工作证明	我要开工作证明
运维平台起不来了	运维平台相关问题	运维平台相关问题	运维平台相关问题
运维平台是否可以提供接口	运维平台相关问题	运维平台相关问题	运维平台相关问题
查看一下现在运维平台的端口号吗？	运维平台相关问题	目前运维平台页面打不开	运维平台相关问题
请问下，运维平台端口怎么修改？	运维平台相关问题	目前运维平台页面打不开	运维平台相关问题
运维平台怎么停止	运维平台相关问题	运维平台相关问题	运维平台相关问题
运维平台访问不了	运维平台相关问题	目前运维平台页面打不开	运维平台相关问题
运维平台相关问题	运维平台相关问题	运维平台相关问题	运维平台相关问题
您好，请问运维平台在哪里下载	运维平台相关问题	运维平台相关问题	运维平台相关问题
用户这边运维平台的admin密码忘记了怎么重置？	运维平台相关问题	系统登录登录验证码图片不显示。	系统登录登录验证码图片不显示。
我公司的账号被锁了，现在需要处理下	我账号被锁定了	我账号怎么被锁了啊	我账号被锁定了
人员帐号锁定了，怎么办？	我账号被锁定了	我账号被锁定了	我账号被锁定了
我账号被锁定了，怎么解决	我账号被锁定了	我账号被锁定了	我账号被锁定了
账号被锁了找谁解决啊	我账号被锁定了	请问如何解决账号被锁问题	我账号被锁定了
我账号出问题了，被锁了打不开	我账号被锁定了	请问如何解决账号被锁问题	我账号被锁定了
账号突然被锁定了	我账号被锁定了	账号被锁定如何处理	我账号被锁定了
如何解决我公司账号被锁问题	我账号被锁定了	请问如何解决账号被锁问题	我账号被锁定了
我账号被锁定了	我账号被锁定了	我账号被锁定了	我账号被锁定了
账号被锁了，有解决方法吗	我账号被锁定了	我账号怎么被锁了啊	我账号被锁定了
我的户口不在上海，可以给我转过来吗	我要转户口	怎么申请转移户口呀	我要转户口
我要迁户口了，帮我办理一下相关手续	我要转户口	可以转户口吗，帮我申请一下	我要转户口
申请迁户口	我要转户口	可以转户口吗，帮我申请一下	我要转户口
你好，我要把我的户口迁过来	我要转户口	我们公司刚搬来这里，需要跟物业交割一下	物业公司的人过来了，请安排相关人员对接下
小e，请帮我申请转移户口	我要转户口	怎么申请转移户口呀	我要转户口
请告诉我转户口需要准备什么，我要转	我要转户口	可以转户口吗，帮我申请一下	我要转户口
我的户口在江苏，能不能给我转到上海	我要转户口	怎么申请转移户口呀	我要转户口
我想转户口	我要转户口	我要转户口	我要转户口
公司体检的流程是什么样的啊	我要体检	我的体检是安排在哪一天	我要体检
我上半年的体检报告什么时候可以拿的到啊	我要体检	我的体检是安排在哪一天	我要体检
我最快什么时候可以拿到我的体检报告啊	我要体检	我的体检是安排在哪一天	我要体检
我准备下个月离职，公司的体检我还可以报名吗	我要体检	我上半年的体检还没体检呢	我要体检
怎么报名今年的员工体检啊	我要体检	我上半年的体检还没体检呢	我要体检
我报名下个月公司的员工体检	我要体检	我上半年的体检还没体检呢	我要体检
我要体检	我要体检	我要体检	我要体检
我可以替我的同事一起报名下个月的公司年度体检吗	我要体检	我上半年的体检还没体检呢	我要体检
客户有两套系统应该怎么去备案	一个客户使用两套系统怎么备案？	一个客户使用两套系统怎么备案？	一个客户使用两套系统怎么备案？
如何解决客户有两套系统的情况	一个客户使用两套系统怎么备案？	系统不能满足客户需求找谁协助？	我们的系统的功能满足不了客户的需求，但客户坚持要开发，该找谁来处理
我们客户想用两套系统怎么处理	一个客户使用两套系统怎么备案？	我想了解客户的系统的使用情况，找谁来询问	我想了解客户的系统的使用情况，找谁来询问
安排一下公司的羽毛球队打球时间和地点	我要打羽毛球	公司下个月的羽毛球大赛怎么报名	我要打羽毛球
我要打羽毛球	我要打羽毛球	我要打羽毛球	我要打羽毛球
组织一下公司羽毛球活动	我要打羽毛球	公司的运动会什么时候举行	公司的活动安排找谁解决
公司每年的羽毛球大赛是什么时候啊	我要打羽毛球	公司下个月的羽毛球大赛怎么报名	我要打羽毛球
公司给员工安排的打羽毛球场地在什么地方啊	我要打羽毛球	下班后我们公司同事一般可以去哪里打羽毛球啊	我要打羽毛球
我现在还可以报名今天晚上的羽毛球比赛吗	我要打羽毛球	公司下个月的羽毛球大赛怎么报名	我要打羽毛球
今年晚上公司有几个人一起打羽毛球啊	我要打羽毛球	下班后我们公司同事一般可以去哪里打羽毛球啊	我要打羽毛球
我们公司有自己固定的羽毛球场地吗	我要打羽毛球	下班后我们公司同事一般可以去哪里打羽毛球啊	我要打羽毛球
我今天特别想打羽毛球，请问怎么可以报名参加	我要打羽毛球	下班可以怎么报名打羽毛球啊	我要打羽毛球
下班后想组个队打羽毛球	我要打羽毛球	下班可以怎么报名打羽毛球啊	我要打羽毛球
绩效考核方案怎么修改啊	我要修改绩效考核方案	绩效考核方案在哪里改啊	我要修改绩效考核方案
帮我改下绩效考核方案	我要修改绩效考核方案	我的绩效考核方案帮我改下	我要修改绩效考核方案
请为我修改绩效考核方案	我要修改绩效考核方案	我要修改绩效考核方案	我要修改绩效考核方案
绩效考核方案可以修改吗	我要修改绩效考核方案	我要修改绩效考核方案	我要修改绩效考核方案
绩效考核方案如何修改	我要修改绩效考核方案	我要修改绩效考核方案	我要修改绩效考核方案
我要修改绩效考核方案	我要修改绩效考核方案	我要修改绩效考核方案	我要修改绩效考核方案
怎么修改绩效考核方案	我要修改绩效考核方案	我要修改绩效考核方案	我要修改绩效考核方案
改下绩效考核方案吧	我要修改绩效考核方案	我的绩效考核方案帮我改下	我要修改绩效考核方案
我一哥们要加入泛微	我有朋友要加入泛微	泛微的女神是谁	特殊-其他
我室友要加入泛微	我有朋友要加入泛微	我有朋友要加入泛微	我有朋友要加入泛微
我有朋友要加入泛微	我有朋友要加入泛微	我有朋友要加入泛微	我有朋友要加入泛微
我的发小要加入泛微	我有朋友要加入泛微	我有朋友要加入泛微	我有朋友要加入泛微
我一姐妹要加入泛微	我有朋友要加入泛微	吴连英工人	特殊-其他
我的闺蜜要加入泛微	我有朋友要加入泛微	我有朋友要加入泛微	我有朋友要加入泛微
我认识的一朋友非常希望能够加入泛微	我有朋友要加入泛微	我有朋友要加入泛微	我有朋友要加入泛微
我朋友很想要加入泛微	我有朋友要加入泛微	我有朋友要加入泛微	我有朋友要加入泛微
帮我做一个代理牌	制作代理牌找谁	我要用代理牌，尽量下周三做好	制作代理牌找谁
我的代理牌坏了，给我重新做一个	制作代理牌找谁	我要用代理牌，尽量下周三做好	制作代理牌找谁
制作代理牌找谁	制作代理牌找谁	制作代理牌找谁	制作代理牌找谁
请问我的代理牌制作好了没	制作代理牌找谁	制作代理牌找谁	制作代理牌找谁
我想申请一下我们部门代理牌的制作	制作代理牌找谁	代理牌制作申请	制作代理牌找谁
请给我做几个代理牌	制作代理牌找谁	制作代理牌找谁	制作代理牌找谁
帮我多做几个代理牌	制作代理牌找谁	我要用代理牌，尽量下周三做好	制作代理牌找谁
申请做个代理牌	制作代理牌找谁	代理牌制作申请	制作代理牌找谁
再给我一张工资条吧	我想重发工资条	工资条发了没	工资条未收到
麻烦重新发一次工资条	我想重发工资条	能重发一张工资条给我吗	我想重发工资条
再发我一张工资条吧	我想重发工资条	工资条发了没	工资条未收到
再领一张工资条	我想重发工资条	能重发一张工资条给我吗	我想重发工资条
请再发我一次工资条	我想重发工资条	我还没收到工资条	工资条未收到
可以重发工资条吗	我想重发工资条	能重发一张工资条给我吗	我想重发工资条
我想重发工资条	我想重发工资条	我想重发工资条	我想重发工资条
重新拿一张工资条	我想重发工资条	能重发一张工资条给我吗	我想重发工资条
中间件支持金蝶吗	支持的国产中间件有哪些	中间件支持中创吗	支持的国产中间件有哪些
中间件支持东方通吗	支持的国产中间件有哪些	中间件支持中创吗	支持的国产中间件有哪些
支持的国产中间件有哪些	支持的国产中间件有哪些	支持的国产中间件有哪些	支持的国产中间件有哪些
我最近还有几次车辆补贴	我要申请车辆补贴	我这个月的车辆补贴为什么还没有到账啊	我要申请车辆补贴
我们公司是不是每个月都有车辆补贴啊	我要申请车辆补贴	为什么我上个月的车辆补贴少了很多	我要申请车辆补贴
每个月的车辆补贴是直接打到我的工资卡里吗	我要申请车辆补贴	工资条可以重发下吗	我想重发工资条
我这个月还可以申请车辆补贴吗	我要申请车辆补贴	我要申请车辆补贴	我要申请车辆补贴
车辆补贴每个月几号发放啊	我要申请车辆补贴	我要申请车辆补贴	我要申请车辆补贴
我刚刚查了我的工资，里面好像没有车辆补贴	我要申请车辆补贴	怎么看工资	我要查工资
每个月的车辆补贴是多少	我要申请车辆补贴	为什么我上个月的车辆补贴少了很多	我要申请车辆补贴
我要申请车辆补贴	我要申请车辆补贴	我要申请车辆补贴	我要申请车辆补贴
云桥升级怎么办	云桥怎么升级	云桥怎么升级	云桥怎么升级
云桥如何升级	云桥怎么升级	云桥怎么升级	云桥怎么升级
云桥要怎么升级	云桥怎么升级	云桥怎么升级	云桥怎么升级
我要云桥升级	云桥怎么升级	我要换城市	我要换城市
请帮我尽快开通流程权限	我想开通流程权限	请尽快开通流程权限，我急需	我想开通流程权限
怎么开通流程权限功能啊	我想开通流程权限	能帮我开一下流程权限功能吗	我想开通流程权限
请为我开通流程权限	我想开通流程权限	我想开通流程权限	我想开通流程权限
请帮我开通流程权限	我想开通流程权限	我想开通流程权限	我想开通流程权限
我需要开通流程权限功能	我想开通流程权限	能帮我开一下流程权限功能吗	我想开通流程权限
可以帮我把流程权限开通吗	我想开通流程权限	如何开通流程权限	我想开通流程权限
我想开通流程权限	我想开通流程权限	我想开通流程权限	我想开通流程权限
开通流程权限的步骤	我想开通流程权限	如何开通流程权限	我想开通流程权限
项目管理产品配置问题找谁？	项目管理产品咨询，配置，需求相关问题？	项目管理产品咨询，配置，需求相关问题？	项目管理产品咨询，配置，需求相关问题？
你们的项目管理有什么特点?	项目管理产品咨询，配置，需求相关问题？	项目管理相关问题	项目管理相关问题
项目管理产品需求相关问题找谁？	项目管理产品咨询，配置，需求相关问题？	项目管理产品咨询，配置，需求相关问题？	项目管理产品咨询，配置，需求相关问题？
项目管理产品相关问题找谁？	项目管理产品咨询，配置，需求相关问题？	项目管理产品咨询，配置，需求相关问题？	项目管理产品咨询，配置，需求相关问题？
客户要开发找谁处理？	我们的系统的功能满足不了客户的需求，但客户坚持要开发，该找谁来处理	这个需求是否已有开发计划？	这个需求是否已有开发计划？
我们的系统的功能满足不了客户的需求，但客户坚持要开发，该找谁来处理	我们的系统的功能满足不了客户的需求，但客户坚持要开发，该找谁来处理	我们的系统的功能满足不了客户的需求，但客户坚持要开发，该找谁来处理	我们的系统的功能满足不了客户的需求，但客户坚持要开发，该找谁来处理
客户坚持要做开发咨询谁？	我们的系统的功能满足不了客户的需求，但客户坚持要开发，该找谁来处理	客户需求开发进度联系谁？	客户化开发需求可行性咨询和讨论评估、客户开发现场调试支持、客户售前技术支持、客户需求开发进度咨询，该找谁处理
客户坚持要二次开发找谁协助？	我们的系统的功能满足不了客户的需求，但客户坚持要开发，该找谁来处理	客户要进行二次开发，该提交什么流程？	二次开发扣款对应哪个流程？二次开发成本是多少？
客户要开发功能找谁咨询？	我们的系统的功能满足不了客户的需求，但客户坚持要开发，该找谁来处理	我们的系统的功能满足不了客户的需求，但客户坚持要开发，该找谁来处理	我们的系统的功能满足不了客户的需求，但客户坚持要开发，该找谁来处理
我想转为正式员工	我要转正	我觉得做产品挺适合我，我可以转去做产品吗	我要调岗转岗
我要转正	我要转正	我要转正	我要转正
我实习期已经过了，可以转正了吧	我要转正	小e，我来公司几个月了，想转正	我要转正
我们老大说我可以转正了	我要转正	抄送功能	特殊-其他
快点转正啊	我要转正	抄送功能	特殊-其他
我要申请成为公司的正式员工	我要转正	活动宣传找谁咨询？	我签约了新客户或进行了一项活动，要宣传，找谁
我入职三个月了，可以转正了	我要转正	小e，我来公司几个月了，想转正	我要转正
给我申请转为正式工	我要转正	我是一名实施工程如何转为项目经理	我是一名实施工程如何转为项目经理
我要采购	我要采购物品	你不投资	特殊-其他
购买打印机	我要采购物品	这台笔记本太卡了，帮我换一台比较新的	我要换个笔记本电脑
咖啡用光了，麻烦加一些	我要采购物品	公司的笔记本电脑一共有多少台啊	我要借用笔记本电脑
我要采购物品	我要采购物品	我要采购物品	我要采购物品
公司的笔记本没有了	我要采购物品	鼠标垫没了	领用一些资产
会议室的幕布需要采购了	我要采购物品	会议室设置相关问题	会议室设置相关问题
最近需要采购一批电话	我要采购物品	我要采购物品	我要采购物品
笔记本没有了，需要采购下	我要采购物品	公司的笔记本电脑一共有多少台啊	我要借用笔记本电脑
我要买礼品	我要采购物品	办公用品采购	我要采购物品
咖啡没了	我要采购物品	地面有水	我的桌子脏了，找谁清理
办公区域的空调购买	我要采购物品	修一下会议室的椅子	我办公室的空调坏了
应用闪退怎么处理	应用一打开就闪退	应用一开闪退咋办	应用一打开就闪退
应用闪退咋搞	应用一打开就闪退	应用一打开就闪退	应用一打开就闪退
应用一开就会闪退	应用一打开就闪退	应用一打开就闪退	应用一打开就闪退
应用一打开就闪退	应用一打开就闪退	应用一打开就闪退	应用一打开就闪退
应用一开就闪退怎么办	应用一打开就闪退	应用一开闪退咋办	应用一打开就闪退
在项目管理中,可以录入项目预算.但如何录入项目实际花费的金额呢?	项目管理相关问题	谁有权修改项目管理模块	项目管理相关问题
项目流程创建不成功	项目管理相关问题	项目实施过程中如何更好的与高层交流？	项目实施过程中如何更好的与高层交流？
不同项目类型有着不同的立项审批过程，你们是如何处理的?	项目管理相关问题	修改项目管理模块该找谁	项目管理相关问题
项目任务卡片字段任务负责人控制	项目管理相关问题	修改项目管理模块该找谁	项目管理相关问题
项目任务分解问题	项目管理相关问题	我们的项目分为项目组和项目管理组两层，如何实现项目信息向项目管理层推送?	项目管理相关问题
项目流程创建失败了	项目管理相关问题	项目实施过程中如何更好的与高层交流？	项目实施过程中如何更好的与高层交流？
项目创建出现空白该找谁解决	项目管理相关问题	在项目中，有些功能不理解该怎么办	在项目中，有些功能不理解该怎么办
项目创建菜单怎么是空白的了	项目管理相关问题	我们的项目管理模块，项目状态是谁有权限修改的	项目管理相关问题
怎样显示项目任务的进度图表?	项目管理相关问题	我们的项目分为项目组和项目管理组两层，如何实现项目信息向项目管理层推送?	项目管理相关问题
你们的系统能够做工程项目管理吗?颗粒度能够管理到多细?	项目管理相关问题	谁有权修改项目管理模块	项目管理相关问题
创建项目流程出现问题了	项目管理相关问题	我们的项目分为项目组和项目管理组两层，如何实现项目信息向项目管理层推送?	项目管理相关问题
创建项目流程显示失败	项目管理相关问题	我们的项目分为项目组和项目管理组两层，如何实现项目信息向项目管理层推送?	项目管理相关问题
项目创建菜单为空白	项目管理相关问题	我们的项目管理模块，项目状态是谁有权限修改的	项目管理相关问题
项目管理相关问题	项目管理相关问题	项目管理相关问题	项目管理相关问题
项目任务甘特图显示问题	项目管理相关问题	我们的项目分为项目组和项目管理组两层，如何实现项目信息向项目管理层推送?	项目管理相关问题
我要换银行卡号	我要换银行卡号	我要换银行卡号	我要换银行卡号
可以帮我换银行卡号吗	我要换银行卡号	能帮我换银行卡号吗	我要换银行卡号
银行卡号能不能换一下	我要换银行卡号	能帮我换银行卡号吗	我要换银行卡号
如何换银行卡号	我要换银行卡号	怎么换银行卡号	我要换银行卡号
给我换下银行卡号	我要换银行卡号	请给我换银行卡号	我要换银行卡号
麻烦帮我换下银行卡号	我要换银行卡号	怎么换银行卡号	我要换银行卡号
换银行卡号可以吗	我要换银行卡号	能帮我换银行卡号吗	我要换银行卡号
标书中的实施问题咨询谁？	我在标书制作过程中，有些技术、实施等问题不清楚，可以问谁	我在标书制作过程中，有些技术、实施等问题不清楚，可以问谁	我在标书制作过程中，有些技术、实施等问题不清楚，可以问谁
标书中的技术问题有疑问向谁了解？	我在标书制作过程中，有些技术、实施等问题不清楚，可以问谁	标书中的技术问题不懂应该找谁咨询？	我在标书制作过程中，有些技术、实施等问题不清楚，可以问谁
标书中的实施问题不懂应该找谁咨询？	我在标书制作过程中，有些技术、实施等问题不清楚，可以问谁	我在标书制作过程中，有些技术、实施等问题不清楚，可以问谁	我在标书制作过程中，有些技术、实施等问题不清楚，可以问谁
标书中的实施问题有疑问向谁了解？	我在标书制作过程中，有些技术、实施等问题不清楚，可以问谁	我在标书制作过程中，有些技术、实施等问题不清楚，可以问谁	我在标书制作过程中，有些技术、实施等问题不清楚，可以问谁
标书中的技术问题咨询谁？	我在标书制作过程中，有些技术、实施等问题不清楚，可以问谁	标书中的技术问题不懂应该找谁咨询？	我在标书制作过程中，有些技术、实施等问题不清楚，可以问谁
我们支持oracle数据库吗	我们支持哪几种国产数据库	迁移oracle数据库的时候，报错了	oracle部署相关问题
国产化数据库软件的支持情况	我们支持哪几种国产数据库	e9支持国产数据库吗	我们支持哪几种国产数据库
咱们系统支持达梦数据库吗	我们支持哪几种国产数据库	达梦数据库可以部署在windows上吗	达梦数据库可以部署在windows上吗
多语言支持sql数据库吗	我们支持哪几种国产数据库	sql server2012企业版正版数据库 大概需要多少钱	数据库报错
我们支持哪几种国产数据库	我们支持哪几种国产数据库	我们支持哪几种国产数据库	我们支持哪几种国产数据库
我们3万人用，数据库服务器你们建议oracle还是sql	我们支持哪几种国产数据库	我们3万人用，数据库服务器你们建议oracle还是sql?	我们支持哪几种国产数据库
我们支持国产数据库吗	我们支持哪几种国产数据库	我们支持哪几种国产数据库	我们支持哪几种国产数据库
我们支持mysql数据库吗	我们支持哪几种国产数据库	安装e9的时候mysql初始化失败，帮我看一下	mysql部署相关问题
我们国产数据库和操作系统支持哪些品牌	我们支持哪几种国产数据库	我们支持哪几种国产数据库	我们支持哪几种国产数据库
你们支持什么数据库?	我们支持哪几种国产数据库	数据库连接的时候出现错误	数据库初始化出现错误
公司有篮球俱乐部吗	我要打篮球	我想加入篮球俱乐部	我要打篮球
新建一个公司的员工篮球队	我要打篮球	公司每周都有篮球比赛吗	我要打篮球
公司给员工安排的篮球场地在什么地方啊	我要打篮球	公司每周都有篮球比赛吗	我要打篮球
我要打篮球	我要打篮球	我要打篮球	我要打篮球
今天晚上帮我组织几个人一起打个篮球	我要打篮球	我要踢足球找谁？	我要打篮球
安排一下下周举办一场篮球比赛	我要打篮球	公司每周都有篮球比赛吗	我要打篮球
公司的篮球比赛是什么时候啊	我要打篮球	公司每周都有篮球比赛吗	我要打篮球
我想看看公司最近篮球的比赛项目是什么	我要打篮球	公司每周都有篮球比赛吗	我要打篮球
我想加入篮球qq群	我要打篮球	移动管理平台	移动管理平台
今天晚上有人报名参加公司的篮球比赛吗	我要打篮球	公司每周都有篮球比赛吗	我要打篮球
我昨天把动态令牌弄丢了现在可以补办一个吗	我要领个动态令牌ukey	我上个月不在公司，我的动态令牌忘记拿了	我要领个动态令牌ukey
我的动态令牌被压坏了怎么可以换一个啊	我要领个动态令牌ukey	地上脏了	我的桌子脏了，找谁清理
我的动态令牌好像没有电了	我要领个动态令牌ukey	地上脏了	我的桌子脏了，找谁清理
去哪里可以领取动态令牌	我要领个动态令牌ukey	我要领个动态令牌ukey	我要领个动态令牌ukey
我的动态令牌显示屏已经花掉了	我要领个动态令牌ukey	我要换个笔记本电脑	我要换个笔记本电脑
我想换一个新的动态令牌	我要领个动态令牌ukey	我找谁换动态令牌啊	我要领个动态令牌ukey
我现在可以去拿我的动态令牌吗	我要领个动态令牌ukey	我要领个动态令牌ukey	我要领个动态令牌ukey
我要领个动态令牌ukey	我要领个动态令牌ukey	我要领个动态令牌ukey	我要领个动态令牌ukey
用户数这个功能完成要多少钱	用户数功能模块价格市场价多少？	复星集团向我们申请增加用户数	licence客户用户数不够用，可以多申请吗？
用户数功能模块价格市场价多少？	用户数功能模块价格市场价多少？	用户数功能模块价格市场价多少？	用户数功能模块价格市场价多少？
用户数功能模块投放到市场值多少钱？	用户数功能模块价格市场价多少？	公司实现用户数功能模块要多少钱？	用户数功能模块价格市场价多少？
我们云桥会务系统应用后台可以售卖吗？	云桥会务系统销售问题	云桥会务系统销售方式有哪些	云桥会务系统销售问题
云桥会务系统销售问题	云桥会务系统销售问题	云桥会务系统销售问题	云桥会务系统销售问题
云桥会务系统销售价格是多少	云桥会务系统销售问题	用户数功能模块价格市场价多少？	用户数功能模块价格市场价多少？
云桥会务系统销售方式？	云桥会务系统销售问题	云桥会务系统销售方式有哪些	云桥会务系统销售问题
云桥会务系统saas版可以作为cology 的一个模块免费使用吗？	云桥会务系统销售问题	云桥能够集成的企业应用有哪些	云桥能够集成的企业应用有哪些
让我看下组织架构图	我想要组织架构图	我想看组织架构图	我想要组织架构图
可以看下组织架构图吗	我想要组织架构图	我想看组织架构图	我想要组织架构图
如何查看要组织架构图	我想要组织架构图	我想要组织架构图	我想要组织架构图
我想要组织架构图	我想要组织架构图	我想要组织架构图	我想要组织架构图
可不可以发我一张公司的组织架构图	我想要组织架构图	公司的组织架构图再给我一份吧	我想要组织架构图
组织架构图在哪里查看	我想要组织架构图	我想看组织架构图	我想要组织架构图
公司的组织架构图发我下	我想要组织架构图	公司的组织架构图再给我一份吧	我想要组织架构图
请发我一份公司的组织架构图	我想要组织架构图	公司的组织架构图再给我一份吧	我想要组织架构图
绩效分值在哪看	我要查询绩效分值	绩效分值请看下	我要查询绩效分值
本月给我打了多少绩效分值	我要查询绩效分值	怎么看绩效分值	我要查询绩效分值
我要查询绩效分值	我要查询绩效分值	我要查询绩效分值	我要查询绩效分值
看下我的绩效分	我要查询绩效分值	我要查询绩效分值	我要查询绩效分值
查一下绩效分值	我要查询绩效分值	绩效分值请看下	我要查询绩效分值
哪里看绩效分值	我要查询绩效分值	怎么看绩效分值	我要查询绩效分值
我这个月的绩效分值是多少	我要查询绩效分值	我要查询绩效分值	我要查询绩效分值
我的绩效分值高吗	我要查询绩效分值	绩效分值请看下	我要查询绩效分值
我的名片还要多久才能好啊	我的名片制作好了没	名片制作ok了吗	我的名片制作好了没
名片作好了吗	我的名片制作好了没	我的名片制作好了没	我的名片制作好了没
我上周提交制作的名片今天可以拿得到吗	我的名片制作好了没	怎么申请做名片	请帮我制作名片
我昨天制作的名片好了吗	我的名片制作好了没	我的名片制作好了没	我的名片制作好了没
我的名片制作好了没	我的名片制作好了没	我的名片制作好了没	我的名片制作好了没
名片还要多久才能拿得到啊	我的名片制作好了没	名片制作ok了吗	我的名片制作好了没
我的名片下周可以取到吗	我的名片制作好了没	名片制作ok了吗	我的名片制作好了没
名片现在制作到哪一步啦	我的名片制作好了没	名片制作ok了吗	我的名片制作好了没
查一下名片做好了吗	我的名片制作好了没	我的名片制作好了没	我的名片制作好了没
查下名片ok了吗	我的名片制作好了没	请帮我制作名片	请帮我制作名片
小e，帮我换一下笔记本电脑	我要换个笔记本电脑	我要换个笔记本电脑	我要换个笔记本电脑
这台笔记本坏了都，换一下	我要换个笔记本电脑	我要换个笔记本电脑	我要换个笔记本电脑
我要换个笔记本电脑	我要换个笔记本电脑	我要换个笔记本电脑	我要换个笔记本电脑
我昨天领的笔记本电脑有点旧了，帮我换一台吧	我要换个笔记本电脑	这台笔记本太卡了，帮我换一台比较新的	我要换个笔记本电脑
我上个月借的笔记本电脑太破了，帮我换一台	我要换个笔记本电脑	我上午的借的笔记本电脑鼠标不能用，帮我换一个	我要换个笔记本电脑
帮我换一个新一点的笔记本电脑吧，下午要演示ppt呢	我要换个笔记本电脑	请问有没有产品演示方面的培训视频？	请问有没有产品演示方面的培训视频？
我明天去恒大公司，帮我换一台新的性能比较的笔记本电脑	我要换个笔记本电脑	这台笔记本太卡了，帮我换一台比较新的	我要换个笔记本电脑
我昨天借的笔记本电脑键盘好像不能用了，给我换一个新的吧	我要换个笔记本电脑	我上午的借的笔记本电脑鼠标不能用，帮我换一个	我要换个笔记本电脑
要重做正式系统的模块	正式系统相关模块的需求变更	正式系统相关模块的需求变更	正式系统相关模块的需求变更
正式系统相关模块的需求变更	正式系统相关模块的需求变更	正式系统相关模块的需求变更	正式系统相关模块的需求变更
正式系统的模块需要修改怎么弄	正式系统相关模块的需求变更	正式系统相关模块的需求变更	正式系统相关模块的需求变更
哪里可以找到投标人员社保证明	要投标人员社保证明	我需要投标人员的社保证明	要投标人员社保证明
投标人员社保证明请给我	要投标人员社保证明	投标人员社保证明有吗，有的话给我	要投标人员社保证明
我现在急需投标人员社保证明	要投标人员社保证明	要投标人员社保证明	要投标人员社保证明
请发我一份投标人员社保证明	要投标人员社保证明	要投标人员社保证明	要投标人员社保证明
请立刻把投标人员社保证明发我	要投标人员社保证明	要投标人员社保证明	要投标人员社保证明
要投标人员社保证明	要投标人员社保证明	要投标人员社保证明	要投标人员社保证明
给我一份投标人员社保证明	要投标人员社保证明	我需要投标人员的社保证明	要投标人员社保证明
可以发我投标人员社保证明吗	要投标人员社保证明	我需要投标人员的社保证明	要投标人员社保证明
物业公司的人过来了，请安排相关人员对接下	物业公司的人过来了，请安排相关人员对接下	物业公司的人过来了，请安排相关人员对接下	物业公司的人过来了，请安排相关人员对接下
公司最近新增了两辆班车，找物业登记车牌	物业公司的人过来了，请安排相关人员对接下	班车停靠点	班车相关问题找谁
修理电梯的人过来了，请安排人员和他对接下	物业公司的人过来了，请安排相关人员对接下	物业找人过来修电梯了，请找人安排对接一下	物业公司的人过来了，请安排相关人员对接下
停电了，找物业看看	物业公司的人过来了，请安排相关人员对接下	停电了	我办公室的空调坏了
公司大门的路不太好，联系物业解决一下	物业公司的人过来了，请安排相关人员对接下	地面有水	我的桌子脏了，找谁清理
物业管理费要交了，商量一下能不能打折	物业公司的人过来了，请安排相关人员对接下	请安排人员和公司的物业对接一下探讨今年的物业费	物业公司的人过来了，请安排相关人员对接下
公司旁边的施工队噪音有些大，请联系物业处理一下	物业公司的人过来了，请安排相关人员对接下	物业公司的人过来了，请安排相关人员对接下	物业公司的人过来了，请安排相关人员对接下
我们的一个供应商对订单有些疑问，请安排联系解决	物业公司的人过来了，请安排相关人员对接下	公司供应商的支付款到了吗	供应商的款项支付了吗
联系电脑供应商确认订单	物业公司的人过来了，请安排相关人员对接下	公司供应商的支付款到了吗	供应商的款项支付了吗
昨天我们办公用品的供应商说今天要来，请安排一下	物业公司的人过来了，请安排相关人员对接下	请安排接待新人	明天有一批新入职人员前来报道，请安排接待
可以换城市吗，我要换	我要换城市	请尽快帮我换到上海的部门	我要换城市
换城市的要求是什么，我想去苏州	我要换城市	请尽快帮我换到上海的部门	我要换城市
我要换城市	我要换城市	我要换城市	我要换城市
可否给我个机会，换去别的城市工作？	我要换城市	我要离职，因为一些个人原因	我要离职
我想去别的城市工作	我要换城市	请让我去北京工作	我要换城市
能不能把我调到别的城市	我要换城市	请尽快帮我换到上海的部门	我要换城市
我要去上海分机构上班	我要换城市	我周末报名值班	我周末报名值班
方便把我更换到杭州工作吗	我要换城市	请尽快帮我换到上海的部门	我要换城市
我老婆生孩子，那我也会享受到公司的福利待遇吗	我要领生孩子礼物	我现在就想看看我生育福利	我要领生孩子礼物
公司对于女员工生育这块会有什么样的福利安排啊	我要领生孩子礼物	我要领取一下我的生育方面的福利	我要领生孩子礼物
我替我老婆来领一下生育奖金	我要领生孩子礼物	我要领一下产育奖金	我要领生孩子礼物
我老婆今年刚生的孩子，我会有什么福利待遇吗	我要领生孩子礼物	我现在就想看看我生育福利	我要领生孩子礼物
我是今年刚入职的，但是我入职前生的孩子，那么还有生孩子礼物吗	我要领生孩子礼物	小e，你好！我要领一下我的生日礼物	我要领生日礼物
我上周刚生完孩子，公司会有这方面的福利吗	我要领生孩子礼物	我要领取一下我的生育方面的福利	我要领生孩子礼物
我要领生孩子礼物	我要领生孩子礼物	我要领生孩子礼物	我要领生孩子礼物
公司对男员工会有什么生育福利吗	我要领生孩子礼物	我要领取一下我的生育方面的福利	我要领生孩子礼物
我今年1月份生的孩子，这方面的福利我还有吗	我要领生孩子礼物	我现在就想看看我生育福利	我要领生孩子礼物
招聘信息一般都要怎么发布啊	我要发布招聘信息	我要发布招聘信息	我要发布招聘信息
如何发布招聘信息	我要发布招聘信息	我要发布招聘信息	我要发布招聘信息
公司的招聘信息要怎么发布啊	我要发布招聘信息	在哪里发布招聘信息啊	我要发布招聘信息
为公司招一些人	我要发布招聘信息	到哪里招人	我要发布招聘信息
想招一些人	我要发布招聘信息	我上个月的电话费充一百块	特殊-其他
怎么招人	我要发布招聘信息	我要离职	我要离职
去哪儿招人	我要发布招聘信息	接人	特殊-其他
发布招聘信息有哪些渠道啊	我要发布招聘信息	在哪里发布招聘信息啊	我要发布招聘信息
我希望能够招人	我要发布招聘信息	到哪里招人	我要发布招聘信息
我要发布招聘信息	我要发布招聘信息	我要发布招聘信息	我要发布招聘信息
公司需要招聘一些人	我要发布招聘信息	我想发下公司的招聘信息	我要发布招聘信息
我希望发布一些招聘信息	我要发布招聘信息	请帮我发布招聘信息	我要发布招聘信息
怎么发布招聘信息啊	我要发布招聘信息	在哪里发布招聘信息啊	我要发布招聘信息
我想招人	我要发布招聘信息	接人	特殊-其他
怎样招人	我要发布招聘信息	如何招人	我要发布招聘信息
流程自定义报表为什么查不到数据	自定义报表相关问题	流程自定义报表怎么分级查看	自定义报表相关问题
流程自定义报表统计怎么出现这种现象了	自定义报表相关问题	流程自定义报表怎么分级查看	自定义报表相关问题
自定义报表相关问题	自定义报表相关问题	自定义报表相关问题	自定义报表相关问题
流程自定义报表可以设置个人的金额合计吗	自定义报表相关问题	流程自定义报表怎么分级查看	自定义报表相关问题
给我升职	我要升职加薪	因我下午开会	特殊-其他
我来公司五年了，我想升职	我要升职加薪	我要升职加薪	我要升职加薪
我要加薪	我要升职加薪	早饭时间	用餐时间
申请升职加薪	我要升职加薪	我要升职加薪	我要升职加薪
签合同时广告交换的问题可以向谁了解？	我签的合同里，涉及到广告交换，怎么处理	签合同涉及广告交换相关问题联系谁？	我签的合同里，涉及到广告交换，怎么处理
合同中广告交换协议找谁咨询？	我签的合同里，涉及到广告交换，怎么处理	签合同涉及广告交换相关问题联系谁？	我签的合同里，涉及到广告交换，怎么处理
谁比较熟悉广告交换相关问题？	我签的合同里，涉及到广告交换，怎么处理	广告交换协议可以咨询谁？	我签的合同里，涉及到广告交换，怎么处理
签合同涉及广告交换可以联系谁？	我签的合同里，涉及到广告交换，怎么处理	签合同涉及广告交换相关问题联系谁？	我签的合同里，涉及到广告交换，怎么处理
我签的合同里，涉及到广告交换，怎么处理	我签的合同里，涉及到广告交换，怎么处理	我签的合同里，涉及到广告交换，怎么处理	我签的合同里，涉及到广告交换，怎么处理
这个职位不太适合我，可以给我转岗吗	我要调岗转岗	可以转岗的话，帮我申请一下	我要调岗转岗
可以调岗的话，帮我申请一下	我要调岗转岗	我希望能调岗到管理阶层	我要调岗转岗
我要调到人事了，帮我办理一下相关手续	我要调岗转岗	我想查一下上海大区的人事行政制度	总部、上海大区人事行政制度的问题?
你好，我想转做会计	我要调岗转岗	你好，我想调到财务部	我要调岗转岗
我觉得做产品挺适合我，我可以调去做产品吗	我要调岗转岗	客户方面要求先付百分之三十的项目款	特殊-其他
我想做行政，不知道可不可以转去这个职位	我要调岗转岗	我希望能调岗到管理阶层	我要调岗转岗
我要调岗转岗	我要调岗转岗	我要调岗转岗	我要调岗转岗
我要换个岗位，去做人事	我要调岗转岗	谁负责人事事宜	人事问题
我希望能转岗做测试	我要调岗转岗	面试算法的工程师到了，安排一下面试	下午有个算法工程师来面试，帮忙接待下
我想做行政，不知道可不可以帮我调到这个职位	我要调岗转岗	我要咨询行政相关的问题	行政
请帮我申请调岗	我要调岗转岗	我要调岗转岗	我要调岗转岗
我要转去做销售了，帮我办理一下相关手续	我要调岗转岗	给我办理离职	我要离职
小e，帮我申请换岗位	我要调岗转岗	这个职位不太适合我，可以给我调换岗位吗	我要调岗转岗
我想转去做开发的工作	我要调岗转岗	这个需求是否已有开发计划？	这个需求是否已有开发计划？
这个纸质投标合同扫描件有问题，能帮我重新扫描一份吗	想要纸质投标合同扫描件	想要纸质投标合同扫描件	想要纸质投标合同扫描件
我想要这个纸质投标合同的扫描件去找谁	想要纸质投标合同扫描件	这个纸质投标合同帮我扫描一下	想要纸质投标合同扫描件
把纸质投标合同扫描件发给我	想要纸质投标合同扫描件	想要纸质投标合同扫描件	想要纸质投标合同扫描件
我的纸质投标合同帮我扫描了吗	想要纸质投标合同扫描件	这个纸质投标合同帮我扫描一下	想要纸质投标合同扫描件
纸质投标合同扫描的相关问题要联系谁	想要纸质投标合同扫描件	想要纸质投标合同扫描件	想要纸质投标合同扫描件
想要纸质投标合同扫描件	想要纸质投标合同扫描件	想要纸质投标合同扫描件	想要纸质投标合同扫描件
这个纸质投标合同能扫描吗	想要纸质投标合同扫描件	这个纸质投标合同帮我扫描一下	想要纸质投标合同扫描件
招投标平台账号密码问题联系谁？	招投标平台注册及账号密码相关问题联系谁？	招投标平台注册及账号密码相关问题联系谁？	招投标平台注册及账号密码相关问题联系谁？
招投标平台账号找谁要	招投标平台注册及账号密码相关问题联系谁？	招投标平台的相关问题联系谁	招投标平台注册及账号密码相关问题联系谁？
谁知道招投标平台账号密码啊	招投标平台注册及账号密码相关问题联系谁？	看一下招投标平台账号和密码	招投标平台注册及账号密码相关问题联系谁？
招投标平台怎么注册账号	招投标平台注册及账号密码相关问题联系谁？	招投标平台怎么进行注册？	招投标平台注册及账号密码相关问题联系谁？
帮我查招投标平台账号及密码	招投标平台注册及账号密码相关问题联系谁？	看一下招投标平台账号和密码	招投标平台注册及账号密码相关问题联系谁？
招投标平台注册及账号密码相关问题联系谁？	招投标平台注册及账号密码相关问题联系谁？	招投标平台注册及账号密码相关问题联系谁？	招投标平台注册及账号密码相关问题联系谁？
招投标平台的网址链接是什么	招投标平台注册及账号密码相关问题联系谁？	招投标平台的相关问题联系谁	招投标平台注册及账号密码相关问题联系谁？
招投标平台账号密码联系人	招投标平台注册及账号密码相关问题联系谁？	招投标平台注册及账号密码相关问题联系谁？	招投标平台注册及账号密码相关问题联系谁？
招投标平台账号忘记密码怎么办	招投标平台注册及账号密码相关问题联系谁？	招投标平台注册及账号密码相关问题联系谁？	招投标平台注册及账号密码相关问题联系谁？
招投标平台账号多少	招投标平台注册及账号密码相关问题联系谁？	招投标平台怎么进行注册？	招投标平台注册及账号密码相关问题联系谁？
招投标平台什么时候开放	招投标平台注册及账号密码相关问题联系谁？	招投标平台怎么进行注册？	招投标平台注册及账号密码相关问题联系谁？
怎么查招投标平台账号和密码	招投标平台注册及账号密码相关问题联系谁？	看一下招投标平台账号和密码	招投标平台注册及账号密码相关问题联系谁？
招投标平台账号密码是啥	招投标平台注册及账号密码相关问题联系谁？	招投标平台注册及账号密码相关问题联系谁？	招投标平台注册及账号密码相关问题联系谁？
查下招标的账号以及密码	招投标平台注册及账号密码相关问题联系谁？	看一下招投标平台账号和密码	招投标平台注册及账号密码相关问题联系谁？
招投标平台登录不了怎么处理	招投标平台注册及账号密码相关问题联系谁？	招投标平台登录要走什么流程	招投标平台注册及账号密码相关问题联系谁？
招标的账号和密码看下	招投标平台注册及账号密码相关问题联系谁？	招投标平台注册及账号密码相关问题联系谁？	招投标平台注册及账号密码相关问题联系谁？
我要看公司特殊激励制度的具体情况	我想了解特殊激励制度	哪里看特殊激励制度	我想了解特殊激励制度
我想了解特殊激励制度	我想了解特殊激励制度	我想了解特殊激励制度	我想了解特殊激励制度
特殊激励制度是什么	我想了解特殊激励制度	怎么看特殊激励制度	我想了解特殊激励制度
搜索特殊激励制度	我想了解特殊激励制度	采编高级搜索时间范围字段标签名不对是什么问题	采编高级搜索时间范围字段标签名不对是什么问题
看下特殊激励制度	我想了解特殊激励制度	哪里看特殊激励制度	我想了解特殊激励制度
查下公司的特殊激励制度	我想了解特殊激励制度	哪里看特殊激励制度	我想了解特殊激励制度
我符合特殊激励制度吗	我想了解特殊激励制度	哪里看特殊激励制度	我想了解特殊激励制度
看下特殊激励制度的内容	我想了解特殊激励制度	怎么看特殊激励制度	我想了解特殊激励制度
如何做到触发流程进行数据审核	怎样触发流程进行数据审批	怎样触发流程进行数据审批	怎样触发流程进行数据审批
如何触发流程进行统计数据核准	怎样触发流程进行数据审批	怎样触发流程进行数据审批	怎样触发流程进行数据审批
怎样做才能触发流程进行数据审核	怎样触发流程进行数据审批	怎样触发流程进行数据审批	怎样触发流程进行数据审批
请帮我开通多人的留言权限	我想开通更多人员的留言权限	可以帮我开通多人留言权限吗	我想开通更多人员的留言权限
我需要开通多人的留言权限	我想开通更多人员的留言权限	可以帮我开通多人留言权限吗	我想开通更多人员的留言权限
我要如何开通多人留言权限	我想开通更多人员的留言权限	可以帮我开通多人留言权限吗	我想开通更多人员的留言权限
我想开通更多人员的留言权限	我想开通更多人员的留言权限	我想开通更多人员的留言权限	我想开通更多人员的留言权限
多人的留言权限如何开通	我想开通更多人员的留言权限	可以帮我开通多人留言权限吗	我想开通更多人员的留言权限
怎么才能开通多人留言权限啊	我想开通更多人员的留言权限	可以帮我开通多人留言权限吗	我想开通更多人员的留言权限
开通多人留言权限的步骤	我想开通更多人员的留言权限	可以帮我开通多人留言权限吗	我想开通更多人员的留言权限
请为我开通多人留言权限	我想开通更多人员的留言权限	可以帮我开通多人留言权限吗	我想开通更多人员的留言权限
如何部署小e？	小e怎么部署？	小e怎么部署？	小e怎么部署？
小e部署环境怎么配置？	小e怎么部署？	现在有e9的服务器配置推荐吗	部署相关问题
小e部署需要什么配置？	小e怎么部署？	小e部署找谁协助？	小e怎么部署？
小e如何配置部署环境？	小e怎么部署？	小e部署找谁协助？	小e怎么部署？
小e怎么部署？	小e怎么部署？	小e怎么部署？	小e怎么部署？
上海大区的人事行政制度找谁？	总部、上海大区人事行政制度的问题?	我想查一下上海大区的人事行政制度	总部、上海大区人事行政制度的问题?
我想查一下总部的人事行政制度	总部、上海大区人事行政制度的问题?	我想查一下上海大区的人事行政制度	总部、上海大区人事行政制度的问题?
总部、上海大区人事行政制度的问题?	总部、上海大区人事行政制度的问题?	总部、上海大区人事行政制度的问题?	总部、上海大区人事行政制度的问题?
总部的人事制度找谁？	总部、上海大区人事行政制度的问题?	谁负责人事事宜	人事问题
总部的行政制度咨询？	总部、上海大区人事行政制度的问题?	行政相关问题	行政
请帮我尽快开通账号	我要开账号	请帮我开通账号	我要开账号
开通账号的步骤	我要开账号	请帮我开通账号	我要开账号
我需要开通账号功能	我要开账号	怎么开通账号功能啊	我要开账号
请为我开通账号	我要开账号	请帮我开通账号	我要开账号
能帮我开一下账号功能吗	我要开账号	怎么开通账号功能啊	我要开账号
我要开账号	我要开账号	我要开账号	我要开账号
请尽快开通账号，我急需	我要开账号	请帮我开通账号	我要开账号
如何开通账号	我要开账号	请帮我开通账号	我要开账号
显示我的工资	我要查工资	我要查工资	我要查工资
工资如何查	我要查工资	工资怎么看	我要查工资
看下我工资清单	我要查工资	我要查工资	我要查工资
请帮我拉下我的银行工资流水账单	我要查工资	我工资错了	我工资错了
看下工资多少	我要查工资	怎么看工资	我要查工资
拉取下我的工资流水单	我要查工资	我要查工资	我要查工资
查下上月工资发了多少	我要查工资	工资发少了吧	我工资错了
可以看下工资吗	我要查工资	怎么看工资	我要查工资
查我上个月的工资	我要查工资	这工资有问题吧	我工资错了
看一下工资发了多少	我要查工资	工资发少了吧	我工资错了
我有很好的市场推广建议,该告诉谁来做宣传	我有很好的市场推广建议,该告诉谁来做宣传	我有很好的市场推广建议,该告诉谁来做宣传	我有很好的市场推广建议,该告诉谁来做宣传
市场推广宣传相关问题找谁咨询？	我有很好的市场推广建议,该告诉谁来做宣传	我有很好的市场推广建议,该告诉谁来做宣传	我有很好的市场推广建议,该告诉谁来做宣传
市场推广活动如何宣传？	我有很好的市场推广建议,该告诉谁来做宣传	市场推广找谁咨询？	我有很好的市场推广建议,该告诉谁来做宣传
市场推广建议怎么宣传？	我有很好的市场推广建议,该告诉谁来做宣传	市场推广找谁咨询？	我有很好的市场推广建议,该告诉谁来做宣传
有市场推广建议可以联系谁？	我有很好的市场推广建议,该告诉谁来做宣传	市场推广相关问题咨询谁？	我有很好的市场推广建议,该告诉谁来做宣传
新客户的合同什么时候办理	新客户的合同办理了吗/寄出去了吗？	新客户合同办理和邮寄的相关问题要联系谁	新客户的合同办理了吗/寄出去了吗？
给新客户的合同谁负责邮寄出去	新客户的合同办理了吗/寄出去了吗？	新客户的合同什么时候能邮寄出去	新客户的合同办理了吗/寄出去了吗？
给新客户邮寄合同要找谁	新客户的合同办理了吗/寄出去了吗？	新客户的合同办好了吗？是否寄出？	新客户的合同办理了吗/寄出去了吗？
我那位新客户的合同办好了吗	新客户的合同办理了吗/寄出去了吗？	新客户合同办理和邮寄的相关问题要联系谁	新客户的合同办理了吗/寄出去了吗？
新客户的合同办理了吗/寄出去了吗？	新客户的合同办理了吗/寄出去了吗？	新客户的合同办理了吗/寄出去了吗？	新客户的合同办理了吗/寄出去了吗？
咨询新客户的合同办理进度	新客户的合同办理了吗/寄出去了吗？	新客户合同办理和邮寄的相关问题要联系谁	新客户的合同办理了吗/寄出去了吗？
这个新客户的合同请尽快帮我办理邮寄出去	新客户的合同办理了吗/寄出去了吗？	新客户的合同办理了吗/寄出去了吗？	新客户的合同办理了吗/寄出去了吗？
新客户合同办好邮寄了吗	新客户的合同办理了吗/寄出去了吗？	新客户的合同办好了吗？是否寄出？	新客户的合同办理了吗/寄出去了吗？
公司可以帮我办理一下贷款吗	我要办理贷款	我明天来公司可以办理贷款吗	我要办理贷款
我上个月刚买了房，现在要办理贷款	我要办理贷款	我是上个月刚入职的现在可以办理贷款吗	我要办理贷款
我的贷款什么时候可以办下来啊	我要办理贷款	我要办理贷款	我要办理贷款
我上个月提交的办理贷款申请什么事实可以批下来	我要办理贷款	我明天来公司可以办理贷款吗	我要办理贷款
我办理贷款还要提供哪些材料啊	我要办理贷款	我要办理贷款	我要办理贷款
我办理贷款的材料还缺什么啊	我要办理贷款	我要办理贷款	我要办理贷款
公司办理贷款有什么限制条件吗	我要办理贷款	我明天来公司可以办理贷款吗	我要办理贷款
我买车了需要办理贷款	我要办理贷款	我要办理贷款	我要办理贷款
系统内核算有问题找谁咨询？	系统内核算项目相关的业务数据问题	系统内核算项目相关的业务数据问题	系统内核算项目相关的业务数据问题
项目相关的业务数据有问题找谁咨询？	系统内核算项目相关的业务数据问题	系统内核算项目相关的业务数据问题	系统内核算项目相关的业务数据问题
系统内核算项目相关的业务数据问题	系统内核算项目相关的业务数据问题	系统内核算项目相关的业务数据问题	系统内核算项目相关的业务数据问题
新客户的合同要寄给谁	新客户合同邮寄给谁？	新客户寄合同应该寄给谁	新客户合同邮寄给谁？
请告诉我新客户的合同应该邮寄给谁	新客户合同邮寄给谁？	新客户合同邮寄给谁？	新客户合同邮寄给谁？
谁知道新客户合同怎么寄	新客户合同邮寄给谁？	新客户合同邮寄给谁？	新客户合同邮寄给谁？
谁负责收寄送新客户的合同	新客户合同邮寄给谁？	新客户合同邮寄给谁？	新客户合同邮寄给谁？
怎么寄新客户的合同	新客户合同邮寄给谁？	新客户合同邮寄给谁？	新客户合同邮寄给谁？
谁知道新客户的合同怎么寄	新客户合同邮寄给谁？	新客户合同邮寄给谁？	新客户合同邮寄给谁？
我想咨询新客户合同邮寄应该寄给谁	新客户合同邮寄给谁？	新客户合同邮寄给谁？	新客户合同邮寄给谁？
你知道新客户的合同可以邮寄给谁吗	新客户合同邮寄给谁？	新客户合同邮寄给谁？	新客户合同邮寄给谁？
帮我查一下寄新客户的合同怎么寄	新客户合同邮寄给谁？	新客户寄合同应该寄给谁	新客户合同邮寄给谁？
新客户合同可以变更哪些协议？	新客户合同变更怎么处理？	新客户合同协议有哪些不能变更的？	新客户合同变更怎么处理？
新客户的合同变更相关问题要联系谁呢？	新客户合同变更怎么处理？	新客户合同变更怎么处理？	新客户合同变更怎么处理？
新客户的合同条款需要修改怎么办？	新客户合同变更怎么处理？	新客户的合同协议可以变更吗？	新客户合同变更怎么处理？
新客户的合同修改变更需要走什么流程呢？	新客户合同变更怎么处理？	新客户合同变更怎么处理？	新客户合同变更怎么处理？
新客户合同变更怎么处理？	新客户合同变更怎么处理？	新客户合同变更怎么处理？	新客户合同变更怎么处理？
新客户的合同可以修改协议吗？	新客户合同变更怎么处理？	新客户的合同协议可以变更吗？	新客户合同变更怎么处理？
新客户需要进行合同协议变更怎么办理	新客户合同变更怎么处理？	新客户的合同协议可以变更吗？	新客户合同变更怎么处理？
新客户合同需要修改找谁？	新客户合同变更怎么处理？	新客户的合同协议可以变更吗？	新客户合同变更怎么处理？
买第三方产品成本要如何控制	要采购第三方产品，如何处理	项目实施成本如何估计？	项目实施成本是多少？
采购第三方产品相关问题找谁？	要采购第三方产品，如何处理	要采购第三方产品，如何处理	要采购第三方产品，如何处理
请问买第三方产品的步骤	要采购第三方产品，如何处理	如何购买第三方产品	要采购第三方产品，如何处理
购第三方产品要注意哪些	要采购第三方产品，如何处理	如何购买第三方产品	要采购第三方产品，如何处理
我需要购第三方产品，找谁咨询啊	要采购第三方产品，如何处理	如何购买第三方产品	要采购第三方产品，如何处理
购第三方产品我不熟悉，找谁啊	要采购第三方产品，如何处理	第三方产品购买的注意点，公司谁知道	要采购第三方产品，如何处理
要采购第三方产品，如何处理	要采购第三方产品，如何处理	要采购第三方产品，如何处理	要采购第三方产品，如何处理
购第三方产品的流程	要采购第三方产品，如何处理	第三方产品购买的注意点，公司谁知道	要采购第三方产品，如何处理
如何更换我系统里的头像	我要换系统头像	请尽快为我更换系统头像	我要换系统头像
我要换下系统里的头像	我要换系统头像	我要换系统头像	我要换系统头像
换系统了，我的头像要更新	我要换系统头像	我要换系统头像	我要换系统头像
换系统里我的头像方便吗，谢谢	我要换系统头像	我要换系统头像	我要换系统头像
请帮我换一张公司系统头像	我要换系统头像	麻烦帮我换下系统头像	我要换系统头像
我想换个头像	我要换系统头像	背诵脚本	特殊-其他
可以更换系统里的头像吗	我要换系统头像	我要换系统头像	我要换系统头像
更换系统头像的步骤	我要换系统头像	请尽快为我更换系统头像	我要换系统头像
我卡牌的头像太丑了重拍一个	我要换系统头像	按y键签到	特殊-其他
我系统里的头像需要更换下	我要换系统头像	我要换系统头像	我要换系统头像
你能不能帮我修改一下系统里我的个人头像啊	我要换系统头像	我系统里的头像请为我换一张新的	我要换系统头像
我们的系统有访问记录吗？	咱们系统有没有访问日志	我要在本机搭建一套系统，要怎么获得安装盘	我要在本机搭建一套系统，要怎么获得安装盘
怎么查询系统最近的访问记录？	咱们系统有没有访问日志	怎么查看系统的访问日志？	咱们系统有没有访问日志
系统访问日志在哪里查看？	咱们系统有没有访问日志	怎么查看系统的访问日志？	咱们系统有没有访问日志
怎么查询系统的访问日志？	咱们系统有没有访问日志	怎么查看系统的访问日志？	咱们系统有没有访问日志
咱们系统有没有访问日志	咱们系统有没有访问日志	咱们系统有没有访问日志	咱们系统有没有访问日志
如果客户想做oa与考勤系统的集成，我们应该怎么考虑哪几方面?	系统集成方面的技术咨询	云桥能够集成的企业应用有哪些	云桥能够集成的企业应用有哪些
异构系统集成可以实现	系统集成方面的技术咨询	如果要与异构系统集成的话，你们可以实现吗	系统集成方面的技术咨询
首页的外部数据元素中,这个已有数据集成是什么地方设置的	系统集成方面的技术咨询	系统内核算项目相关的业务数据问题	系统内核算项目相关的业务数据问题
开放平台可以和哪些应用集成?	系统集成方面的技术咨询	运维平台需要集成到第三方监控平台	运维平台相关问题
对于财务凭证集成的需求，应该注意哪些问题?	系统集成方面的技术咨询	我们系统支持哪些财务系统的凭证集成	我们系统支持哪些财务系统的凭证集成
客户有集成方面的问题需要找人咨询	系统集成方面的技术咨询	集成问题找谁	集成问题
客户的集成问题	系统集成方面的技术咨询	如何集成	集成问题
如何与第三方的档案管理系统集成?	系统集成方面的技术咨询	系统文档迁移方案	系统文档迁移方案
人员合同签订流程是否可以跟异构系统集成，集成如何实现?	系统集成方面的技术咨询	需要电子合同扫描件走什么流程？	想要电子投标合同扫描件
永中部署完以后与oa系统集成的相关配置项	系统集成方面的技术咨询	oa系统要和很多系统集成，接口是免费提供的吗?	系统集成方面的技术咨询
档案管理系统集成问题	系统集成方面的技术咨询	系统文档迁移方案	系统文档迁移方案
云桥迁移怎么搞	云桥怎么迁移	云桥怎么迁移	云桥怎么迁移
我要迁移云桥	云桥怎么迁移	啊我今天忘带key了	我忘带key了
云桥要迁移我该怎么办	云桥怎么迁移	云桥怎么迁移	云桥怎么迁移
云桥如何迁移	云桥怎么迁移	云桥怎么迁移	云桥怎么迁移
为什么在收款未结算表中标记为未归档？	在收款未结算表中写未归档是什么情况？	收款未结算表中写未归档是因为什么？	在收款未结算表中写未归档是什么情况？
收款未结算表中的未归档意味着什么？	在收款未结算表中写未归档是什么情况？	收款未结算表中的未归档是什么意思？	在收款未结算表中写未归档是什么情况？
在收款未结算表中写未归档是什么情况？	在收款未结算表中写未归档是什么情况？	在收款未结算表中写未归档是什么情况？	在收款未结算表中写未归档是什么情况？
收款未结算表中的未归档是指什么？	在收款未结算表中写未归档是什么情况？	收款未结算表中的未归档是什么意思？	在收款未结算表中写未归档是什么情况？
为什么在收款未结算表中有未归档的说明？	在收款未结算表中写未归档是什么情况？	收款未结算表中写未归档是因为什么？	在收款未结算表中写未归档是什么情况？
收款未结算表中的未归档说明什么？	在收款未结算表中写未归档是什么情况？	收款未结算表中的未归档是什么意思？	在收款未结算表中写未归档是什么情况？
收款未结算表中写未归档是什么原因？	在收款未结算表中写未归档是什么情况？	收款未结算表中写未归档是因为什么？	在收款未结算表中写未归档是什么情况？
为什么在收款未结算表中显示未归档？	在收款未结算表中写未归档是什么情况？	在收款未结算表中写未归档是什么情况？	在收款未结算表中写未归档是什么情况？
业绩核算数据问题找谁？	我的业绩不对或者业绩需要拆分贡献比例，业绩核算调整找谁	项目业绩核算有问题找谁？	项目业绩核算有问题找谁？
业绩核算调整找谁咨询？	我的业绩不对或者业绩需要拆分贡献比例，业绩核算调整找谁	业绩核算有误怎么解决？	我的业绩不对或者业绩需要拆分贡献比例，业绩核算调整找谁
业绩核算有误联系谁？	我的业绩不对或者业绩需要拆分贡献比例，业绩核算调整找谁	业绩核算有误怎么解决？	我的业绩不对或者业绩需要拆分贡献比例，业绩核算调整找谁
我对业绩核算结果有点疑问找谁咨询？	我的业绩不对或者业绩需要拆分贡献比例，业绩核算调整找谁	项目业绩核算有问题找谁？	项目业绩核算有问题找谁？
业绩有问题找谁咨询？	我的业绩不对或者业绩需要拆分贡献比例，业绩核算调整找谁	我上个月绩效计算少了一项	我绩效错了
业绩拆分咨询谁？	我的业绩不对或者业绩需要拆分贡献比例，业绩核算调整找谁	我的业绩不对或者业绩需要拆分贡献比例，业绩核算调整找谁	我的业绩不对或者业绩需要拆分贡献比例，业绩核算调整找谁
我要办理居住证积分，找谁办	我要办理居住证积分	我要办理居住证积分	我要办理居住证积分
请帮我申请一下办居住证积分业务	我要办理居住证积分	我要办理居住证积分	我要办理居住证积分
你知道居住证积分申请办理要找谁吗	我要办理居住证积分	我要办理居住证积分	我要办理居住证积分
我想办理一下居住证的积分	我要办理居住证积分	我要办理居住证积分	我要办理居住证积分
我来上海工作三年了，帮我办一下办居住证积分	我要办理居住证积分	小e，我要办我的居住证积分	我要办理居住证积分
你知道居住证积分怎么办吗	我要办理居住证积分	我要办理居住证积分	我要办理居住证积分
你好，我要申请居住证积分办理	我要办理居住证积分	要办理居住证积分需要什么材料	我要办理居住证积分
申请一下，办理居住证积分	我要办理居住证积分	我要办理居住证积分	我要办理居住证积分
新客户的合同审核通过了吗？	新客户合同审核/合同预审	新客户的合同找谁审核啊？	新客户合同审核/合同预审
新客户合同怎么审核？	新客户合同审核/合同预审	新客户的合同找谁审核啊？	新客户合同审核/合同预审
新客户的合同审核有什么问题吗？	新客户合同审核/合同预审	新客户合同审核的相关问题咨询谁？	新客户合同审核/合同预审
新客户的合同审核了吗？	新客户合同审核/合同预审	新客户的合同找谁审核啊？	新客户合同审核/合同预审
新客户合同预审的相关问题联系谁呢？	新客户合同审核/合同预审	新客户合同审核的相关问题咨询谁？	新客户合同审核/合同预审
新客户合同审核要走什么流程？	新客户合同审核/合同预审	新客户合同审核的相关问题咨询谁？	新客户合同审核/合同预审
新客户合同审核/合同预审	新客户合同审核/合同预审	新客户合同审核/合同预审	新客户合同审核/合同预审
新客户的合同预审了吗？	新客户合同审核/合同预审	新客户的合同什么时候审核？	新客户合同审核/合同预审
有没有不同数据库下的性能对比数据	我们有不同数据库下的性能对比报告吗	我们有不同数据库下的性能对比报告吗	我们有不同数据库下的性能对比报告吗
我们有不同数据库下的性能对比报告吗	我们有不同数据库下的性能对比报告吗	我们有不同数据库下的性能对比报告吗	我们有不同数据库下的性能对比报告吗
关于不同数据库下的性能对比	我们有不同数据库下的性能对比报告吗	我们有不同数据库下的性能对比报告吗	我们有不同数据库下的性能对比报告吗
想参与一场对我们有价值的外部活动，怎么做	我希望参与一场外部活动对我们有价值，我想参与进去，不知道怎么合作？	我希望参与一场外部活动对我们有价值，我想参与进去，不知道怎么合作？	我希望参与一场外部活动对我们有价值，我想参与进去，不知道怎么合作？
怎么参与外部活动	我希望参与一场外部活动对我们有价值，我想参与进去，不知道怎么合作？	我希望参与一场外部活动对我们有价值，我想参与进去，不知道怎么合作？	我希望参与一场外部活动对我们有价值，我想参与进去，不知道怎么合作？
我希望参与一场外部活动对我们有价值，我想参与进去，不知道怎么合作？	我希望参与一场外部活动对我们有价值，我想参与进去，不知道怎么合作？	我希望参与一场外部活动对我们有价值，我想参与进去，不知道怎么合作？	我希望参与一场外部活动对我们有价值，我想参与进去，不知道怎么合作？
如何合作参与外部联盟的活动	我希望参与一场外部活动对我们有价值，我想参与进去，不知道怎么合作？	我希望参与一场外部活动对我们有价值，我想参与进去，不知道怎么合作？	我希望参与一场外部活动对我们有价值，我想参与进去，不知道怎么合作？
这个月的绩效分数不正常，应该找谁解决啊	我绩效错了	怎么看绩效分值	我要查询绩效分值
我这个月的绩效好像不太对	我绩效错了	我上个月绩效计算少了一项	我绩效错了
这个月的绩效数据出错了	我绩效错了	请给我处理一下，我的绩效数据不准确	我绩效错了
绩效数据错了怎么办	我绩效错了	谁负责绩效啊，我的数据有错误	我绩效错了
你知道绩效出错找谁处理吗	我绩效错了	我绩效错了	我绩效错了
我绩效错了	我绩效错了	我绩效错了	我绩效错了
你看我这个绩效评分是不是不太对啊	我绩效错了	我要查询绩效分值	我要查询绩效分值
我的绩效分数算的不对，你再算一下	我绩效错了	怎么看绩效分值	我要查询绩效分值
招投标资质证书找谁要？	招投标文件所需的各类资质审核的证书找谁要	你这边有投标人员资质证书吗，有的话给我一份	要投标人员资质证书
资质审核证书找谁咨询？	招投标文件所需的各类资质审核的证书找谁要	新员工考核咨询谁？	新员工考核咨询谁？
招投标资质审核证书谁有？	招投标文件所需的各类资质审核的证书找谁要	招投标资质审核证书有吗？	招投标文件所需的各类资质审核的证书找谁要
资质审核证书谁有？	招投标文件所需的各类资质审核的证书找谁要	公司借用资质证书原件如何提流程	借用资质证书原件走什么流程
资质审核证书去哪里找？	招投标文件所需的各类资质审核的证书找谁要	公司借用资质证书原件如何提流程	借用资质证书原件走什么流程
