想了解e-office价格的客户	想了解e-office价格的客户
流程分享可设置为能否查看流转意见的需求有计划吗	流程分享可设置为能否查看流转意见的需求有计划吗
数据到期了如何发送相关提醒	数据到期了如何发送相关提醒
客户想延长超时登出时间，这个的配置文件在哪	客户想延长超时登出时间，这个的配置文件在哪
配置超时登出时间的文件找谁要	客户想延长超时登出时间，这个的配置文件在哪
客户要配置超时登出时间找谁	客户想延长超时登出时间，这个的配置文件在哪
文档附件docx类型文件无法在线打开是什么问题？	文档附件docx类型文件无法在线打开是什么问题？
e-ofice10.0 有哪些在线阅读插件？	e-ofice10.0 有哪些在线阅读插件？
e-ofice10.0 有阅读小程序吗？	e-ofice10.0 有哪些在线阅读插件？
e-ofice10.0 有配套的阅读插件吗？	e-ofice10.0 有哪些在线阅读插件？
ofd集成问题	ofd集成问题
我们的oa是否支持ofd文件的转换和预览	ofd集成问题
财务	财务
财务问题	财务
咨询财务相关问题	财务
日志分析平台找谁？	日志分析平台找谁？
同一个知识文档，谷歌打开文档出现与文档毫无相关的文档信息，兼容模式打开正常，是什么原因	同一个知识文档，谷歌打开文档出现与文档毫无相关的文档信息，兼容模式打开正常，是什么原因
执行力平台	执行力平台
薪酬管理功能找谁	薪酬管理功能找谁
系统安全问题找谁	系统安全问题找谁
你们如何保证系统安全？	系统安全问题找谁
你们系统安全措施有哪些？	系统安全问题找谁
你们的系统安全做得怎么样？	系统安全问题找谁
系统安全能保证吗？	系统安全问题找谁
系统安全专家有哪些？	系统安全问题找谁
系统安全相关问题咨询谁？	系统安全问题找谁
安全等保相关咨询	系统安全问题找谁
安全等级保护找谁？	系统安全问题找谁
安全等级保护专家有哪些？	系统安全问题找谁
你们系统是怎么解决安全等级保护问题的？	系统安全问题找谁
你们系统的安全等级保护怎么样？	系统安全问题找谁
安全等保相关问题找谁？	系统安全问题找谁
安全等保措施有哪些？	系统安全问题找谁
安全补丁包问题找谁？	系统安全问题找谁
安全方案咨询	系统安全问题找谁
安全测试没通过	系统安全问题找谁
安全报告事宜找谁	系统安全问题找谁
预算导入时报错，请问这个是因为什么	预算导入时报错，请问这个是因为什么
我们支持哪些国产cpu芯片	我们支持哪些国产cpu芯片
知识管理模块修改文档里的超链接，其他所有超链接都改成相同的链接是怎么回事	知识管理模块修改文档里的超链接，其他所有超链接都改成相同的链接是怎么回事
resin问题找谁	resin问题找谁
薪资模块是否支持了新个税计算扣税功能。	薪资模块是否支持了新个税计算扣税功能。
凭证推送如何配置	凭证推送如何配置
产品bug找谁	产品bug找谁
我要升职加薪	我要升职加薪
我来公司五年了，我想升职	我要升职加薪
我要加薪	我要升职加薪
给我升职	我要升职加薪
即时通讯问题找谁	即时通讯问题找谁
即时通讯咨询谁	即时通讯问题找谁
我绩效错了	我绩效错了
我这个月的绩效好像不太对	我绩效错了
这个月的绩效数据出错了	我绩效错了
你看我这个绩效评分是不是不太对啊	我绩效错了
绩效数据错了怎么办	我绩效错了
你知道绩效出错找谁处理吗	我绩效错了
请给我处理一下，我的绩效数据不准确	我绩效错了
我上个月绩效计算少了一项	我绩效错了
e9新功能咨询	e9新功能咨询
mysql部署相关问题	mysql部署相关问题
mysql的集群部署相关问题	mysql部署相关问题
mysql集群有什么方案吗	mysql部署相关问题
mysql的集群部署方案	mysql部署相关问题
为什么不建议使用mysql?	mysql部署相关问题
mysql初始化过程有异常	mysql部署相关问题
mysql初始化的时候有异常	mysql部署相关问题
mysql初始化过程有问题	mysql部署相关问题
mysql初始化中有异常	mysql部署相关问题
mysql初始化过程有特殊异常	mysql部署相关问题
mysql初始化过程失败	mysql部署相关问题
mysql如何备份恢复	mysql部署相关问题
mysql备份恢复怎么搞	mysql部署相关问题
mysql备份恢复要怎么办	mysql部署相关问题
mysql怎么备份恢复	mysql部署相关问题
mysql怎么从备份里恢复	mysql部署相关问题
mysql迁移后resin启动异常	mysql部署相关问题
mysql迁移后resin启动有问题	mysql部署相关问题
契约锁合同提交什么流程/契约锁合同找谁	契约锁合同提交什么流程/契约锁合同找谁
契约锁合同问题应该提什么流程	契约锁合同提交什么流程/契约锁合同找谁
契约锁合同流程怎么提	契约锁合同提交什么流程/契约锁合同找谁
契约锁合同提哪个流程	契约锁合同提交什么流程/契约锁合同找谁
你知道契约锁合同找谁吗	契约锁合同提交什么流程/契约锁合同找谁
我想咨询契约锁合同谁负责	契约锁合同提交什么流程/契约锁合同找谁
我想提交关于契约锁合同的一个流程	契约锁合同提交什么流程/契约锁合同找谁
我要咨询契约锁合同相关知识	契约锁合同提交什么流程/契约锁合同找谁
流程数据归档怎样转到建模	流程数据归档怎样转到建模
流程数据归档如何转到建模	流程数据归档怎样转到建模
调查已经生效了，但是想要更改调查表的内容，该怎么办？	调查已经生效了，但是想要更改调查表的内容，该怎么办？
e-cology系统demo相关问题	e-cology系统demo相关问题
我需要在本地申请装一套e-cology产品的demo系统，该怎么做	e-cology系统demo相关问题
怎样申请和安装本地e-cology产品demo？	e-cology系统demo相关问题
申请搭建ecology产品demo找谁咨询？	e-cology系统demo相关问题
本地e-cology产品demo如何搭建？	e-cology系统demo相关问题
搭建demo系统咨询谁？	e-cology系统demo相关问题
本地搭建e-cology找谁咨询？	e-cology系统demo相关问题
如何申请搭建本地ecology系统？	e-cology系统demo相关问题
询问提供行业或场景应用的demo体验和下载地址，以及demo使用中的各种问题	e-cology系统demo相关问题
咨询demo本地安装以及使用中的问题	e-cology系统demo相关问题
咨询如何复用demo中的模板、素材、应用，以及搭建思路	e-cology系统demo相关问题
“我的演示”下面的素材库的体验地址报错了，该找谁？	e-cology系统demo相关问题
“我的演示”模块的贸易行业演示demo的license到期了，该找谁？	e-cology系统demo相关问题
演示模块素材库体验地址出错咨询谁？	e-cology系统demo相关问题
演示demo的license到期可以找谁咨询？	e-cology系统demo相关问题
演示demo的license到期了怎么解决？	e-cology系统demo相关问题
演示模块功能体验地址报错怎么解决？	e-cology系统demo相关问题
演示demo的license到期了找谁协助？	e-cology系统demo相关问题
我们的e-cology产品的demo系统无法访问，怎么办	e-cology系统demo相关问题
e-cology产品的demo系统无法访问怎么解决？	e-cology系统demo相关问题
e-cology产品demo系统访问不了找谁协助？	e-cology系统demo相关问题
e-cology产品的demo系统无法访问找谁咨询？	e-cology系统demo相关问题
e-cology产品demo系统访问有问题怎么办？	e-cology系统demo相关问题
e-cology产品的demo系统不能访问怎么办？	e-cology系统demo相关问题
e-cology产品的demo系统访问不了怎么解决？	e-cology系统demo相关问题
我想要一些有行业特点的e-cologydemo、解决方案、成功案例的等应该找谁	e-cology系统demo相关问题
我要索取泛微解决方案，该找谁	e-cology系统demo相关问题
e-cology成功案例有哪些？	e-cology系统demo相关问题
e-cology成功案例找谁要？	e-cology系统demo相关问题
e-cology的demo找谁咨询？	e-cology系统demo相关问题
e-cology行业方案咨询谁？	e-cology系统demo相关问题
e-cology行业方案谁有？	e-cology系统demo相关问题
我想索要e-cologydemo系统中的数据，该怎么处理	e-cology系统demo相关问题
退票如何操作？	退票如何操作？
财务开的发票怎么退票处理	退票如何操作？
怎么退票	退票如何操作？
退票问题如何解决	退票如何操作？
退票问题怎么处理	退票如何操作？
退票问题如何处理	退票如何操作？
退票问题怎么解决	退票如何操作？
财务开的发票要如何退票处理	退票如何操作？
licence授权问题找谁	licence授权问题找谁
licence问题谁能解决	licence授权问题找谁
谁负责处理licence授权	licence授权问题找谁
找个人帮忙解决一下licence授权问题	licence授权问题找谁
公司哪里可以领药品	公司哪里可以领药品
找前台拿点感冒药	公司哪里可以领药品
我要感冒药	公司哪里可以领药品
领几片阿莫西林	公司哪里可以领药品
我要申领一盒感冒药	公司哪里可以领药品
我感冒了，帮我拿点感冒药	公司哪里可以领药品
请帮我拿一些治胃疼的药	公司哪里可以领药品
找行政取一瓶西瓜霜	公司哪里可以领药品
领用胃药	公司哪里可以领药品
治感冒的药比如感冒胶囊，给我一点	公司哪里可以领药品
帮我拿一喝三九胃泰	公司哪里可以领药品
找谁领胃药	公司哪里可以领药品
知识目录中创建新的文档上传单附件后，直接点击下载无法下载，是只能到文档附件页签选择具体附件才能下载吗	知识目录中创建新的文档上传单附件后，直接点击下载无法下载，是只能到文档附件页签选择具体附件才能下载吗
有时候定位不准	有时候定位不准
定位不准的时候怎么办	有时候定位不准
定位不准	有时候定位不准
定位经常不准	有时候定位不准
契约锁全程电子化体验demo地址是？	契约锁全程电子化体验demo地址是？
契约锁demo地址是多少	契约锁全程电子化体验demo地址是？
发表的楼层可以删除吗？哪些人有删除权限？	发表的楼层可以删除吗？哪些人有删除权限？
老客户的合同办理了吗/寄出去了吗？	老客户的合同办理了吗/寄出去了吗？
老客户的合同办好了吗？是否寄出？	老客户的合同办理了吗/寄出去了吗？
老客户合同办好邮寄了吗	老客户的合同办理了吗/寄出去了吗？
老客户的合同什么时候办理	老客户的合同办理了吗/寄出去了吗？
老客户的合同什么时候能邮寄出去	老客户的合同办理了吗/寄出去了吗？
给老客户的合同谁负责邮寄出去	老客户的合同办理了吗/寄出去了吗？
给老客户邮寄合同要找谁	老客户的合同办理了吗/寄出去了吗？
这个老客户的合同请尽快帮我办理邮寄出去	老客户的合同办理了吗/寄出去了吗？
互联网行业我们做过哪些客户？	互联网行业我们做过哪些客户？
万达是我们客户吗？	互联网行业我们做过哪些客户？
华为是我们的客户吗	互联网行业我们做过哪些客户？
复星集团是我们客户嘛？	互联网行业我们做过哪些客户？
用户邮箱空间满了怎么办，怎么扩大用户的空间	用户邮箱空间满了怎么办，怎么扩大用户的空间
参与范围，增减和删除数据都有问题怎么办	参与范围，增减和删除数据都有问题怎么办
svn管理找谁	svn管理找谁
svn	svn管理找谁
发票开错了要怎么办	发票开错了要怎么办
发票抬头写错啦还能报销吗	发票开错了要怎么办
发票的抬头开错了，我该怎么办	发票开错了要怎么办
发票的信息填写有误	发票开错了要怎么办
发票的内容填写错了	发票开错了要怎么办
发票写错了可以吗	发票开错了要怎么办
发票的信息不小心开错了	发票开错了要怎么办
发票错了如何报销	发票开错了要怎么办
发票信息填写错误怎么报销	发票开错了要怎么办
发票抬头写错了怎么办	发票开错了要怎么办
开发票需要哪些证明	发票开错了要怎么办
发票开错了怎么办	发票开错了要怎么办
发票抬头错了	发票开错了要怎么办
发票上的承担人填错了	发票开错了要怎么办
发票上的纳锐人识别号填写不正确	发票开错了要怎么办
申请开两张发票	发票开错了要怎么办
发票相关问题应该咨询谁	发票开错了要怎么办
咨询下开具发票的相关问题	发票开错了要怎么办
客户有另外要求,发票怎么开	发票开错了要怎么办
发票识别查验标准集成的供应商是哪家	发票开错了要怎么办
发票识别查验客户想要换供应商是否可以	发票开错了要怎么办
开发票信息缺失的如何处理	发票开错了要怎么办
开发票信息缺失要怎么办	发票开错了要怎么办
开发票信息缺失的解决办法	发票开错了要怎么办
没有税号怎么开票	发票开错了要怎么办
开发票信息缺失还能开票吗	发票开错了要怎么办
没有税号能否开具发票	发票开错了要怎么办
没有税号是否还能开具发票	发票开错了要怎么办
没有税号是否还能开票	发票开错了要怎么办
没有税号能不能开具发票	发票开错了要怎么办
发票丢了还能报销吗	发票开错了要怎么办
费用报销发票找不到了	发票开错了要怎么办
客户需要技术支持	客户需要技术支持
谁安排技术支持	客户需要技术支持
技术支持怎么安排	客户需要技术支持
可以用客户的合同模版签合同吗？	可以用客户的合同模版签合同吗？
可不可以用客户的合同模版签合同？	可以用客户的合同模版签合同吗？
公司允许签合同用合同模版吗？	可以用客户的合同模版签合同吗？
用客户的合同模版签合同可以吗？	可以用客户的合同模版签合同吗？
公司让不让用客户的合同模版来签合同	可以用客户的合同模版签合同吗？
我想问一下，可不可以用客户的合同模版签合同？	可以用客户的合同模版签合同吗？
我想用合同模版签新合同	可以用客户的合同模版签合同吗？
使用客户的合同模版签合同是否被允许	可以用客户的合同模版签合同吗？
我要换系统照片	我要换系统照片
我要换下系统里的照片	我要换系统照片
如何更换我系统里的照片	我要换系统照片
我系统里的照片需要更换下	我要换系统照片
麻烦帮我换下系统照片	我要换系统照片
请尽快为我更换系统照片	我要换系统照片
更换系统照片的步骤	我要换系统照片
可以更换系统里的照片吗	我要换系统照片
我系统里的照片请为我换一张新的	我要换系统照片
公众号连接成功后就要配置菜单，emobile会不会把原来客户微信的菜单给同步掉呀？	公众号连接成功后就要配置菜单，emobile会不会把原来客户微信的菜单给同步掉呀？
mobile配置菜单会同步掉原来客户的微信菜单吗	公众号连接成功后就要配置菜单，emobile会不会把原来客户微信的菜单给同步掉呀？
em7相关问题	em7相关问题
部署em7，e9不能开放外网怎么办	em7相关问题
如何在外网部署em7和e9	em7相关问题
在外网部署em7和e9出现问题了	em7相关问题
em7出问题了	em7相关问题
em7的相关手册文档在哪里	em7相关问题
请问一下em7必须要和e9一起销售是吧，是否可以独立销售独立部署？？	em7相关问题
em7工作台404错误问题	em7相关问题
em7下载安装问题	em7相关问题
em7如何下载安装	em7相关问题
em6如何升级到em7	em7相关问题
em7安装vc++失败是怎么回事	em7相关问题
内测版em7客户端哪里可以下载	em7相关问题
请问emobile7问题找谁？	em7相关问题
请问emobile7问题咨询谁？	em7相关问题
问下emobile7问题怎么办？	em7相关问题
我要申请手机话费	我要申请手机话费
我的手机话费不够用了我要申请手机话费	我要申请手机话费
手机话费应该怎么申请啊	我要申请手机话费
我今年刚入职的可以申请手机话费吗	我要申请手机话费
我上个月和客户联系比较多，所以我想申请手机话费	我要申请手机话费
上个月的手机话费这个月可以申请吗	我要申请手机话费
我这个月的手机话费可以报销吗	我要申请手机话费
我想报销这个月的手机话费	我要申请手机话费
怎么查收款	怎么查收款
我上个月的项目收款到账多少	怎么查收款
我签得合同收到钱了吗	怎么查收款
我的合同收到钱了吗	怎么查收款
我的订单收到钱了吗	怎么查收款
复星的合同收款到账没	怎么查收款
我不知道是否收款	怎么查收款
查看收款情况	怎么查收款
在已办事宜中查看，流程的显示模板当前节点的模板吗？	在已办事宜中查看，流程的显示模板当前节点的模板吗？
契约所报价单找谁	契约所报价单找谁
请问谁负责契约锁报价	契约所报价单找谁
契约锁报价问题应该找谁	契约所报价单找谁
谁知道契约锁的报价	契约所报价单找谁
我要找人咨询契约锁的报价问题	契约所报价单找谁
契约锁怎么报价	契约所报价单找谁
契约锁报价多少	契约所报价单找谁
请给我契约锁的报价	契约所报价单找谁
契约锁报价问题是谁在负责	契约所报价单找谁
契约锁价格如何	契约所报价单找谁
咨询契约锁价格	契约所报价单找谁
契约锁产品如何报价	契约所报价单找谁
契约锁产品报价单找谁？	契约所报价单找谁
契约锁产品卖多少钱？	契约所报价单找谁
契约锁电子签及印控产品报价	契约所报价单找谁
契约锁产品怎么报价？	契约所报价单找谁
云桥会务系统销售问题	云桥会务系统销售问题
云桥会务系统销售方式？	云桥会务系统销售问题
云桥会务系统销售价格是多少	云桥会务系统销售问题
云桥会务系统销售流程怎么走	云桥会务系统销售问题
云桥会务系统销售方式有哪些	云桥会务系统销售问题
表单公式	表单公式
e9新考勤是否支持和钉钉集成同步。	e9新考勤是否支持和钉钉集成同步。
什么是数字信封？	什么是数字信封？
解释下数字信封	什么是数字信封？
阐述下数字信封	什么是数字信封？
怎么设置调查参与人不可以查看调查结果	怎么设置调查参与人不可以查看调查结果
公文流程与文档审批流程能同时使用吗	公文流程与文档审批流程能同时使用吗
oa是否能将组织架构和人员信息同步到ad域或openldap中，即ad域或openldap中的数据由oa进行维护？	oa是否能将组织架构和人员信息同步到ad域或openldap中，即ad域或openldap中的数据由oa进行维护？
第三方产品价格	第三方产品价格
第三方产品的价格介绍	第三方产品价格
永中产品价格是多少啊	第三方产品价格
帆软产品价格是多少啊	第三方产品价格
问下视频会议系统产品的价格	第三方产品价格
服务器产品价格一般是多少	第三方产品价格
帮我查下电脑产品的价格	第三方产品价格
ocr识别产品的市场价是多少	第三方产品价格
为什么licence申请流程一提交就被退回？	为什么licence申请流程一提交就被退回？
为什么我不能申请licence	为什么licence申请流程一提交就被退回？
licence申请条件	为什么licence申请流程一提交就被退回？
licence申请流程怎么提交	为什么licence申请流程一提交就被退回？
我怎么申请licence	为什么licence申请流程一提交就被退回？
licence授权申请	为什么licence申请流程一提交就被退回？
licence怎么申请	为什么licence申请流程一提交就被退回？
在哪里提交licence申请流程	为什么licence申请流程一提交就被退回？
附件无法上传问题	附件无法上传问题
附件无法上传怎么办	附件无法上传问题
附件上传失败怎么办	附件无法上传问题
附件上传有问题	附件无法上传问题
附件上传功能失效怎么办	附件无法上传问题
我要换银行卡号	我要换银行卡号
可以帮我换银行卡号吗	我要换银行卡号
能帮我换银行卡号吗	我要换银行卡号
请给我换银行卡号	我要换银行卡号
换银行卡号可以吗	我要换银行卡号
如何换银行卡号	我要换银行卡号
怎么换银行卡号	我要换银行卡号
银行卡号能不能换一下	我要换银行卡号
物业公司的人过来了，请安排相关人员对接下	物业公司的人过来了，请安排相关人员对接下
公司大门的路不太好，联系物业解决一下	物业公司的人过来了，请安排相关人员对接下
公司最近新增了两辆班车，找物业登记车牌	物业公司的人过来了，请安排相关人员对接下
物业管理费要交了，商量一下能不能打折	物业公司的人过来了，请安排相关人员对接下
停电了，找物业看看	物业公司的人过来了，请安排相关人员对接下
昨天我们办公用品的供应商说今天要来，请安排一下	物业公司的人过来了，请安排相关人员对接下
我们的一个供应商对订单有些疑问，请安排联系解决	物业公司的人过来了，请安排相关人员对接下
刚确定一个新供应商，跟他们对接一下	物业公司的人过来了，请安排相关人员对接下
公司旁边的施工队噪音有些大，请联系物业处理一下	物业公司的人过来了，请安排相关人员对接下
我们公司刚搬来这里，需要跟物业交割一下	物业公司的人过来了，请安排相关人员对接下
联系电脑供应商确认订单	物业公司的人过来了，请安排相关人员对接下
能否用建模实现xx功能	能否用建模实现xx功能
这个功能建模能不能实现	能否用建模实现xx功能
薪资统计能不能用建模做	能否用建模实现xx功能
如何用建模做薪资统计	能否用建模实现xx功能
licence客户用户数不够用，可以多申请吗？	licence客户用户数不够用，可以多申请吗？
我的客户数不够用，想申请licence	licence客户用户数不够用，可以多申请吗？
帮我申请查询客户的licence	licence客户用户数不够用，可以多申请吗？
客户太少了,可以申请licence吗	licence客户用户数不够用，可以多申请吗？
可以多申请客户用户吗	licence客户用户数不够用，可以多申请吗？
客户用户数可以额外申请吗	licence客户用户数不够用，可以多申请吗？
如何申请客户户数许可	licence客户用户数不够用，可以多申请吗？
复星集团向我们申请增加用户数	licence客户用户数不够用，可以多申请吗？
licence口头承诺赠送给客户用户数可以申请吗 ？	licence客户用户数不够用，可以多申请吗？
我说要给客户licence现在要申请一个	licence客户用户数不够用，可以多申请吗？
我说承诺赠送licence现在需要申请	licence客户用户数不够用，可以多申请吗？
承诺赠送给客户用户数licence可以吗 ？	licence客户用户数不够用，可以多申请吗？
licence口头承诺赠送给客户用户数能申请吗 ？	licence客户用户数不够用，可以多申请吗？
licence赠送给客户用户数可以口头承诺吗 ？	licence客户用户数不够用，可以多申请吗？
licence口头承诺赠能申请送给客户用户数吗 ？	licence客户用户数不够用，可以多申请吗？
产品用户手册是找你吗	产品用户手册是找你吗
什么是时间戳？	什么是时间戳？
微搜为什么搜索不到数据？	微搜为什么搜索不到数据？
微搜服务为什么启动不起来？	微搜为什么搜索不到数据？
使用微搜无法出来结果	微搜为什么搜索不到数据？
微搜没有反馈	微搜为什么搜索不到数据？
微搜无法使用	微搜为什么搜索不到数据？
微搜什么都没有	微搜为什么搜索不到数据？
微搜功能无法使用	微搜为什么搜索不到数据？
搜微无法运行	微搜为什么搜索不到数据？
搜微用不了	微搜为什么搜索不到数据？
微搜能根据 表单里 某个字段值来搜出对应的流程吗	微搜为什么搜索不到数据？
e9新考勤是否支持带薪假-年假等自动根据规则自动生成。	e9新考勤是否支持带薪假-年假等自动根据规则自动生成。
界面设计找谁	界面设计找谁
报销流程权限没有怎么办	报销流程权限没有怎么办
为什么我没有报销的权限啊	报销流程权限没有怎么办
你可以帮我开通一下我的报销权限吗	报销流程权限没有怎么办
我好像不能管理报销流程，是不是没有权限啊	报销流程权限没有怎么办
我的报销流程权限你可以帮我打开吗	报销流程权限没有怎么办
我的报销权限怎么被关了	报销流程权限没有怎么办
我上午去审批报销发现我的报销权限没有了	报销流程权限没有怎么办
我上午刚刚发现我的报销权限没有了	报销流程权限没有怎么办
契约锁有的新功能的结构说明吗	契约锁有的新功能的结构说明吗
什么是契约锁	契约锁有的新功能的结构说明吗
契约锁的说明文档	契约锁有的新功能的结构说明吗
能否通过系统配置实现银企直连，如付款成功，能否生成付款核算凭证，传送到财务系统?	能否通过系统配置实现银企直连，如付款成功，能否生成付款核算凭证，传送到财务系统?
明细表增强插件列字段规则合计不对怎么解决	明细表增强插件列字段规则合计不对怎么解决
售前支持	售前支持
我需要售前支持	售前支持
部门要组织旅游	部门要组织旅游
帮我们部门组织一次春天旅游	部门要组织旅游
我们部门准备去泰国来一次旅游	部门要组织旅游
部门旅游有金额限制吗	部门要组织旅游
部门旅游有什么限制吗	部门要组织旅游
今年我们部门的春季旅游可以去哪些地方啊	部门要组织旅游
部门旅游是可以自己选择地方吗	部门要组织旅游
部门旅游的地点都有哪些啊	部门要组织旅游
资产管理相关问题	资产管理相关问题
你们的资产管理主要是管什么?	资产管理相关问题
怎样修改资产信息?	资产管理相关问题
我想要修改资产信息该找谁解决	资产管理相关问题
如何修改资产相关信息	资产管理相关问题
在哪里修改资产信息	资产管理相关问题
资产领用、归还等动作如何与流程关联?	资产管理相关问题
如果我们资产管理系统，你们的资产流程能够自动生成资产台账码?	资产管理相关问题
资产导入报错	资产管理相关问题
资产导入出错了	资产管理相关问题
资产导入失败了	资产管理相关问题
我导入资产失败了，要找谁解决	资产管理相关问题
资产要清理数据，重新导入	资产管理相关问题
怎么对入库的资产进行报废处理	资产管理相关问题
请问维修状态的资产谁有权限通过归还流程选择到这个资产	资产管理相关问题
你们的资产管理功能里面，是否支持对于资产全生命周期的管理?	资产管理相关问题
资产相关流程提交不成功	资产管理相关问题
资产组分权问题	资产管理相关问题
怎样查看资产情况?	资产管理相关问题
咨询资产组分权	资产管理相关问题
有个项目需要人支持	有个项目需要人支持
第三集团军项目事宜找谁	有个项目需要人支持
这个项目谁负责支持的	有个项目需要人支持
人力资源接口文档说明	人力资源接口文档说明
人力资源接口文档说明找谁要？	人力资源接口文档说明
人力资源接口文档在哪里？	人力资源接口文档说明
哪里有人力资源接口文档？	人力资源接口文档说明
人力资源接口的文档说明找谁要？	人力资源接口文档说明
人力资源接口文档在哪里查看？	人力资源接口文档说明
税率变更了，怎么办？	税率变更了，怎么办？
发票的税率可以随意更改吗	税率变更了，怎么办？
发票的税率可以自己改吗	税率变更了，怎么办？
税率变更如何处理？	税率变更了，怎么办？
税率变更如何解决？	税率变更了，怎么办？
税率变更要咋办？	税率变更了，怎么办？
税率变更怎么解决？	税率变更了，怎么办？
发票的税率变了要怎么办	税率变更了，怎么办？
流程在流转过程中，上传的附件丢失。在数据库中看到表单中保存的附件的主键是16502，这要怎么解决呢	流程在流转过程中，上传的附件丢失。在数据库中看到表单中保存的附件的主键是16502，这要怎么解决呢
会议室排座功能有实现计划吗	会议室排座功能有实现计划吗
哈希算法是整个电子合同应用中防篡改一个关键技术，是如何实现的？	哈希算法是整个电子合同应用中防篡改一个关键技术，是如何实现的？
云商店客户端部署时用户覆盖出错问题	云商店客户端部署时用户覆盖出错问题
公司每月进行的新员工产品培训或者，我又不在现场，这些新功能我到哪里去学习呢？	公司每月进行的新员工产品培训或者，我又不在现场，这些新功能我到哪里去学习呢？
想问下，我们小e是非标功能?	想问下，我们小e是非标功能?
小e是属于非标功能吗？	想问下，我们小e是非标功能?
小e是否属于非标功能？	想问下，我们小e是非标功能?
小e是否属于标准功能？	想问下，我们小e是非标功能?
小e是非标准功能吗？	想问下，我们小e是非标功能?
最新的webservice文档	最新的webservice文档
最新的webservice文档能发给我一下吗？	最新的webservice文档
我想要最新的webservice文档	最新的webservice文档
合同文件需要盖章走什么流程？	合同文件需要盖章走什么流程？
合同盖章应该提交什么流程？	合同文件需要盖章走什么流程？
我需要盖章合同文件	合同文件需要盖章走什么流程？
合同文件需要盖章如何申请？	合同文件需要盖章走什么流程？
合同文件用章怎么走流程？	合同文件需要盖章走什么流程？
我的这个合同文件要盖章	合同文件需要盖章走什么流程？
公司合同文件盖章如何提流程？	合同文件需要盖章走什么流程？
合同文件用章要怎么申请啊？	合同文件需要盖章走什么流程？
我们是否有党建管理平台	我们是否有党建管理平台
有项目合作的伙伴	有项目合作的伙伴
外部邮件怎么才能自动接收邮件	外部邮件怎么才能自动接收邮件
sap有问题找谁	sap有问题找谁
谁负责sap相关问题	sap有问题找谁
我有sap相关的疑问，找谁能解决呢	sap有问题找谁
ie下打印时，弹出确认提示？	ie下打印时，弹出确认提示？
请问客户想申请非标走什么流程？	请问客户想申请非标走什么流程？
客户想申请非标找谁咨询？	请问客户想申请非标走什么流程？
非标功能定制申请走什么流程？	请问客户想申请非标走什么流程？
客户想查看非标功能怎么申请	请问客户想申请非标走什么流程？
契约锁人工客服	契约锁人工客服
帮我找一下契约锁的人工客服	契约锁人工客服
契约锁的人工客服是谁	契约锁人工客服
契约锁有没有人工客服	契约锁人工客服
泛微对外宣传形象设计广告文件	泛微对外宣传形象设计广告文件
泛微对外宣传广告文件找谁要？	泛微对外宣传形象设计广告文件
泛微形象宣传文件找谁？	泛微对外宣传形象设计广告文件
泛微广告文件咨询谁？	泛微对外宣传形象设计广告文件
公司形象设计文件找谁要？	泛微对外宣传形象设计广告文件
云桥会务系统中可以实现红包功能吗	云桥会务系统中可以实现红包功能吗
培训考试时间怎么安排的	培训考试时间怎么安排的
给客户安装系统时，需要提交license，我该找谁来申请	给客户安装系统时，需要提交license，我该找谁来申请
license申请走什么流程？	给客户安装系统时，需要提交license，我该找谁来申请
license申请找谁咨询？	给客户安装系统时，需要提交license，我该找谁来申请
license怎么申请？	给客户安装系统时，需要提交license，我该找谁来申请
license申请相关问题联系谁？	给客户安装系统时，需要提交license，我该找谁来申请
e9开发案例有吗？	e9开发案例有吗？
360浏览器中无法打开	360浏览器中无法打开
客户卡片没有最终用户编号	客户卡片没有最终用户编号
客户卡片的最终用户编号在哪找	客户卡片没有最终用户编号
客户的最终用户编号咨询谁	客户卡片没有最终用户编号
客户卡片的最终用户编号可以修改吗	客户卡片没有最终用户编号
最终用户编号显示不了怎么办	客户卡片没有最终用户编号
客户卡片的最终用户编号的相关问题联系谁	客户卡片没有最终用户编号
最终用户编号	客户卡片没有最终用户编号
客户的最终用户编号怎么查询	客户卡片没有最终用户编号
我要换城市	我要换城市
我想去别的城市工作	我要换城市
能不能把我调到别的城市	我要换城市
我家在南京，想去我们公司的南京分部工作	我要换城市
请让我去北京工作	我要换城市
我要去上海分机构上班	我要换城市
可以换城市吗，我要换	我要换城市
可否给我个机会，换去别的城市工作？	我要换城市
社保怎么查询	社保怎么查询
小e，社保缴费情况怎么查呀	社保怎么查询
你知道社保怎么查吗	社保怎么查询
能不能告诉我怎么查询社保信息	社保怎么查询
我想查一下我的社保信息	社保怎么查询
我的社保情况帮我查一下	社保怎么查询
请给我查查看我的社保缴费情况	社保怎么查询
社保信息一般在哪里能够查到呀	社保怎么查询
怎么查询社保，给我说一下	社保怎么查询
crm谁维护	crm谁维护
crm模块出现问题应该找谁	crm谁维护
代理商余款多少？	代理商余款多少？
代理商那里还剩多少钱？	代理商余款多少？
我们的经销商还有多少钱在那？	代理商余款多少？
契约锁项目资源	契约锁项目资源
谁是销售经理	谁是销售经理
西藏营销管理部负责人	谁是销售经理
后台设置进不去找谁	后台设置进不去找谁
个人付款需要提供什么证明	个人付款需要提供什么证明
我收钱了怎么开证明	个人付款需要提供什么证明
个人需要填写什么证明才可以收款	个人付款需要提供什么证明
我可以自己收钱吗	个人付款需要提供什么证明
收到货款后，要开证明吗	个人付款需要提供什么证明
开具收款证明	个人付款需要提供什么证明
收款要什么证明	个人付款需要提供什么证明
请帮我开一下付款的相关证明	个人付款需要提供什么证明
付款需要哪些证明资料	个人付款需要提供什么证明
同一个html显示模板，对同一个目录下的文档，有的起作用，有的不起作用是什么原因	同一个html显示模板，对同一个目录下的文档，有的起作用，有的不起作用是什么原因
契约锁招聘岗位有什么要求	契约锁招聘岗位有什么要求
契约锁招聘岗位要求是怎样的？	契约锁招聘岗位有什么要求
契约锁招聘岗位的要求是什么？	契约锁招聘岗位有什么要求
契约锁招聘对人才素质要求是怎样的？	契约锁招聘岗位有什么要求
我要开通邮箱	我要开通邮箱
我需要开通邮箱功能	我要开通邮箱
请帮我开通邮箱	我要开通邮箱
请为我开通邮箱	我要开通邮箱
能帮我开一下邮箱功能吗	我要开通邮箱
如何开通邮箱	我要开通邮箱
开通邮箱的步骤	我要开通邮箱
可以帮我把公司邮箱开通吗	我要开通邮箱
请帮我尽快开通邮箱	我要开通邮箱
怎么开通邮箱功能啊	我要开通邮箱
信息采编如何实现成文	信息采编如何实现成文
sap提供webservice接口或rest接口，oa是否可以调用，将流程的审批数据推送到sap？	sap提供webservice接口或rest接口，oa是否可以调用，将流程的审批数据推送到sap？
我们的oa系统能否调用sap提供webservice接口或rest接口，将流程的审批数据推送到sap？	sap提供webservice接口或rest接口，oa是否可以调用，将流程的审批数据推送到sap？
列表模式下，协作主题操作的问题	列表模式下，协作主题操作的问题
更换个人分机号码找谁	更换个人分机号码找谁
分机号码修改	更换个人分机号码找谁
你好，我想改一下我的分机号	更换个人分机号码找谁
请帮我修改一下分机号码	更换个人分机号码找谁
我的分机电话号，帮忙改一下	更换个人分机号码找谁
我的工位换了，帮我改一下分机号	更换个人分机号码找谁
我的分机电话号太难记了，能不能换一个	更换个人分机号码找谁
改下我的分机电话号	更换个人分机号码找谁
管理员是不是一定能看到所有文档	管理员是不是一定能看到所有文档
在收款未结算表中写未验收是什么情况？	在收款未结算表中写未验收是什么情况？
收款未结算表中的未验收是什么意思？	在收款未结算表中写未验收是什么情况？
收款未结算表中的未验收是指什么？	在收款未结算表中写未验收是什么情况？
收款未结算表中的未验收意味着什么？	在收款未结算表中写未验收是什么情况？
收款未结算表中的未验收说明什么？	在收款未结算表中写未验收是什么情况？
收款未结算表中写未验收是什么原因？	在收款未结算表中写未验收是什么情况？
收款未结算表中写未验收是因为什么？	在收款未结算表中写未验收是什么情况？
为什么在收款未结算表中还有未验收这一项？	在收款未结算表中写未验收是什么情况？
制作代理牌找谁	制作代理牌找谁
帮我做一个代理牌	制作代理牌找谁
我的代理牌坏了，给我重新做一个	制作代理牌找谁
代理牌制作申请	制作代理牌找谁
我要用代理牌，尽量下周三做好	制作代理牌找谁
请给我做几个代理牌	制作代理牌找谁
我想申请一下我们部门代理牌的制作	制作代理牌找谁
帮我多做几个代理牌	制作代理牌找谁
党建管理平台问题找谁	党建管理平台问题找谁
新客户合同邮寄给谁？	新客户合同邮寄给谁？
怎么寄新客户的合同	新客户合同邮寄给谁？
谁负责收寄送新客户的合同	新客户合同邮寄给谁？
谁知道新客户的合同怎么寄	新客户合同邮寄给谁？
邮寄新客户的合同，接收人是谁	新客户合同邮寄给谁？
新客户寄合同应该寄给谁	新客户合同邮寄给谁？
新客户的合同要寄给谁	新客户合同邮寄给谁？
请告诉我新客户的合同应该邮寄给谁	新客户合同邮寄给谁？
你知道新客户的合同可以邮寄给谁吗	新客户合同邮寄给谁？
客户问企业认证正常情况下多久可以通过？	客户问企业认证正常情况下多久可以通过？
契约锁企业认证需要多久？	客户问企业认证正常情况下多久可以通过？
谁是重庆大区总经理	谁是重庆大区总经理
license上传错误	license上传错误
系统登录支持指纹登录吗。	系统登录支持指纹登录吗。
公文审批人无法保存	公文审批人无法保存
公文审批人无法保存怎么办	公文审批人无法保存
公文中的审批人怎么没法保存呢	公文审批人无法保存
客户报备在office平台还是cology平台？	客户报备在office平台还是cology平台？
客户报备可兼容什么平台？	客户报备在office平台还是cology平台？
我想找客户报备在哪找	客户报备在office平台还是cology平台？
建模查询中心	建模查询中心
建模查询中心是谁负责的	建模查询中心
薪资模块是否和微信工资单结合	薪资模块是否和微信工资单结合
引用发表一个有相关内容的帖子，结果新帖子中也展示了被引用的相关内容，是怎么回事？	引用发表一个有相关内容的帖子，结果新帖子中也展示了被引用的相关内容，是怎么回事？
云商店明细表插件表单打开报错是什么原因？	云商店明细表插件表单打开报错是什么原因？
数据中心产品咨询，配置，需求相关问题？	数据中心产品咨询，配置，需求相关问题？
数据中心产品相关问题找谁？	数据中心产品咨询，配置，需求相关问题？
数据中心配置相关问题找谁？	数据中心产品咨询，配置，需求相关问题？
数据中心需求相关问题找谁？	数据中心产品咨询，配置，需求相关问题？
我签约了新客户怎么没发新闻呢	我签约了新客户怎么没发新闻呢
签约了的客户怎么没有新闻呢？	我签约了新客户怎么没发新闻呢
我签约的客户发新闻了吗？	我签约了新客户怎么没发新闻呢
我签的客户为什么没有发新闻？	我签约了新客户怎么没发新闻呢
我签了新客户但是新闻上还没有呢？	我签约了新客户怎么没发新闻呢
我想知道请假制度	我想知道请假制度
我们公司对请假有什么要求	我想知道请假制度
帮我查一下公司关于请假的相关规定	我想知道请假制度
请假的制度有哪些	我想知道请假制度
请假有什么规定吗	我想知道请假制度
我想知道公司对请假有什么制度规定	我想知道请假制度
我们公司请假好请吗？有没有什么要求规定	我想知道请假制度
我们公司的请假制度是什么样子的，给我看一下	我想知道请假制度
西南大区总经理是谁	西南大区总经理是谁
报销流程支持选择费用申请流程的具体明细进行分别冲抵的功能可以改进吗	报销流程支持选择费用申请流程的具体明细进行分别冲抵的功能可以改进吗
字段联动，有问题找谁？	字段联动，有问题找谁？
请问市场活动设计物料支持，应该找谁，走什么流程	请问市场活动设计物料支持，应该找谁，走什么流程
市场活动需要设计支持找谁？	请问市场活动设计物料支持，应该找谁，走什么流程
我要换系统头像	我要换系统头像
我要换下系统里的头像	我要换系统头像
如何更换我系统里的头像	我要换系统头像
我系统里的头像需要更换下	我要换系统头像
麻烦帮我换下系统头像	我要换系统头像
请尽快为我更换系统头像	我要换系统头像
更换系统头像的步骤	我要换系统头像
可以更换系统里的头像吗	我要换系统头像
我系统里的头像请为我换一张新的	我要换系统头像
请帮我换一张公司系统头像	我要换系统头像
换系统里我的头像方便吗，谢谢	我要换系统头像
我卡牌的头像太丑了重拍一个	我要换系统头像
一条发文流程上传的附件，有些审批人员打开是最终版本，有些人打开是留痕版本，要如何默认统一是最终版本呢	一条发文流程上传的附件，有些审批人员打开是最终版本，有些人打开是留痕版本，要如何默认统一是最终版本呢
我们有不同数据库下的性能对比报告吗	我们有不同数据库下的性能对比报告吗
我们客户这边让给出一个系统性能报告，这个怎么弄	我们有不同数据库下的性能对比报告吗
关于不同数据库下的性能对比	我们有不同数据库下的性能对比报告吗
这个需求哪个版本可以实现	这个需求哪个版本可以实现
我在实施或售前过程中遇到了需求，知道如何实现吗？有没有类似的资料？	我在实施或售前过程中遇到了需求，知道如何实现吗？有没有类似的资料？
督办消息中心主键冲突怎么解决	督办消息中心主键冲突怎么解决
契约锁有什么资质	契约锁有什么资质
我要咨询契约锁资质问题	契约锁有什么资质
契约锁有哪些资质	契约锁有什么资质
契约锁资质查询	契约锁有什么资质
请帮我查询契约锁资质	契约锁有什么资质
契约锁已获得哪些资质	契约锁有什么资质
给我找一下契约锁的资质	契约锁有什么资质
契约锁的资质有哪几个	契约锁有什么资质
怎么查询契约锁的相关资质	契约锁有什么资质
谁知道契约锁有什么资质	契约锁有什么资质
e9新考勤是否支持跨天排班考勤。	e9新考勤是否支持跨天排班考勤。
报销流程承担公司选不了怎么办	报销流程承担公司选不了怎么办
我在报销的时候发现承担公司这个不能选择了	报销流程承担公司选不了怎么办
我的报销时候承担公司那一栏没法选择公司	报销流程承担公司选不了怎么办
报销的时候选择承担公司为什么会失败	报销流程承担公司选不了怎么办
报销流程时候如果承担公司选择不了我可以找谁啊	报销流程承担公司选不了怎么办
你好，你可以帮我看看我的报销里面承担公司不能选择了	报销流程承担公司选不了怎么办
我昨天晚上报销的时候发现承担公司里面的公司好像都不能选择了	报销流程承担公司选不了怎么办
我正在报销，但是承担公司却不能选择	报销流程承担公司选不了怎么办
我要开收入证明	我要开收入证明
我准备办理去日本的签证，公司这边可以帮我开个收入证明吗	我要开收入证明
我今年买房子了银行需要收入证明	我要开收入证明
我的收入证明你可以帮我盖个章吗	我要开收入证明
收入证明需要我准备哪些材料啊	我要开收入证明
我的收入证明上的收入金额好像不太对啊	我要开收入证明
我的收入证明需要你在上面盖一个公司公章	我要开收入证明
可以麻烦你帮我开一个收入证明吗	我要开收入证明
我们有适配过arm的cpu环境吗	我们有适配过arm的cpu环境吗
mobile相关问题	mobile相关问题
移动办公问题	mobile相关问题
移动办公	mobile相关问题
emessage问题找谁	mobile相关问题
e-message私有云起不来	mobile相关问题
e-message连接故障	mobile相关问题
移动端出了问题找谁呀？	mobile相关问题
手机端有问题找谁	mobile相关问题
移动端的流程与pc端的流程共用一个接口吗	mobile相关问题
移动端的流程与pc端的流程接口都一样吗	mobile相关问题
e-message异常	mobile相关问题
emobile问题	mobile相关问题
e9登录超时是前端什么组件问题导致的吗	e9登录超时是前端什么组件问题导致的吗
发现邮件接收下来没有存到收件箱，反而被移动到了已发送或者垃圾箱等其他菜单里面，是什么原因呐？	发现邮件接收下来没有存到收件箱，反而被移动到了已发送或者垃圾箱等其他菜单里面，是什么原因呐？
售前演示demo部署客户服务器无法访问云商店问题	售前演示demo部署客户服务器无法访问云商店问题
图片显示不出来及无法下载附件的问题如何解决	图片显示不出来及无法下载附件的问题如何解决
契约锁售前支持	契约锁售前支持
契约锁售前咨询	契约锁售前支持
谁负责公司的网络营销	谁负责公司的网络营销
公司的网络营销找谁咨询？	谁负责公司的网络营销
网络营销相关问题找谁咨询？	谁负责公司的网络营销
我想了解一下网络营销可以咨询谁？	谁负责公司的网络营销
公司的网络营销是谁负责的？	谁负责公司的网络营销
建模培训问题	建模培训问题
建模的培训找谁	建模培训问题
网络分发找谁	网络分发找谁
督查督办e8e9有何区别？	督查督办e8e9有何区别？
推荐朋友应聘契约锁找谁	推荐朋友应聘契约锁找谁
契约锁推荐入职找谁？	推荐朋友应聘契约锁找谁
契约锁人才推荐找谁咨询？	推荐朋友应聘契约锁找谁
契约锁人才推荐走什么流程？	推荐朋友应聘契约锁找谁
我们支持哪些国产操作系统	我们支持哪些国产操作系统
e8能在国产化终端下使用吗	我们支持哪些国产操作系统
用户客户端使用麒麟系统访问ecology 我请教下谁	我们支持哪些国产操作系统
e9支持linux系统安装吗	我们支持哪些国产操作系统
我们的系统平台支持申威cpu吗	我们支持哪些国产操作系统
e9支持什么国产的操作系统	我们支持哪些国产操作系统
我们支持哪些国产中间件	我们支持哪些国产操作系统
国产化服务器操作系统支持情况	我们支持哪些国产操作系统
国产化服务器操作系统和中间件支持情况	我们支持哪些国产操作系统
车辆能不能只能申请本分部的车辆	车辆能不能只能申请本分部的车辆
车辆能不能只能控制申请	车辆能不能只能申请本分部的车辆
e8发文库的文号 签发人如何才能显示	e8发文库的文号 签发人如何才能显示
契约锁私有化相关问题	契约锁私有化相关问题
契约锁私有化应用案例及场景？	契约锁私有化相关问题
契约锁的私有化系统是什么？	契约锁私有化相关问题
简单介绍一下契约锁私有化系统？	契约锁私有化相关问题
契约锁私有化系统有哪些实践案例？	契约锁私有化相关问题
契约锁私有化系统做过什么实际场景？	契约锁私有化相关问题
公司都做过哪些契约锁私有化的案例	契约锁私有化相关问题
都有哪些契约锁私有化案例	契约锁私有化相关问题
我想看下有契约锁私有化相关的实际场景	契约锁私有化相关问题
契约锁私有化有哪些场景？	契约锁私有化相关问题
契约锁私有云windows环境部署	契约锁私有化相关问题
契约锁私有云linux环境部署	契约锁私有化相关问题
契约锁私有化部署对硬件有什么要求？	契约锁私有化相关问题
契约锁系统私有化安装部署找谁？	契约锁私有化相关问题
契约锁私有化系统部署支持？	契约锁私有化相关问题
契约锁私有化系统部署是否需要外网？	契约锁私有化相关问题
契约锁私有化部署环境要求？	契约锁私有化相关问题
契约锁私有化如何与第三方系统集成？	契约锁私有化相关问题
契约锁私有化与ec集成需要进行什么配置？	契约锁私有化相关问题
契约锁私有化如何与ecology集成？	契约锁私有化相关问题
客户是内网的情况上，是否可以通过开放端口实现企业微信的使用，具体要开放哪些端口呢？	客户是内网的情况上，是否可以通过开放端口实现企业微信的使用，具体要开放哪些端口呢？
系统登录扫码登录机制扫码是什么。	系统登录扫码登录机制扫码是什么。
有关对电子签名的法律依据？	有关对电子签名的法律依据？
云商店流程明细导入显示成功，但是表单没有数据	云商店流程明细导入显示成功，但是表单没有数据
如何申请加入一个协作？	如何申请加入一个协作？
android原生app的集成开发相关问题？	android原生app的集成开发相关问题？
有没有android原生app的集成开发相关问题？	android原生app的集成开发相关问题？
android原生app的集成开发有关问题有吗？	android原生app的集成开发相关问题？
android原生app的集成开发上面的问题？	android原生app的集成开发相关问题？
正式系统相关模块的需求变更	正式系统相关模块的需求变更
要重做正式系统的模块	正式系统相关模块的需求变更
客户对正式系统相关模块的需求有变	正式系统相关模块的需求变更
谁是ebu开发平台技术总监	谁是ebu开发平台技术总监
我要领取医保卡	我要领取医保卡
我已经入职一个月了，医保卡办好了吗	我要领取医保卡
医保卡办好了怎么领啊	我要领取医保卡
你好，你知道医保卡去哪里领取吗	我要领取医保卡
我想领一下我的医保卡	我要领取医保卡
小e，帮我领一下医保卡	我要领取医保卡
我想申请领医保卡	我要领取医保卡
医保卡如果办好了帮我领一下	我要领取医保卡
大概入职多久医保卡能够办好呀	我要领取医保卡
数据误删	数据误删
契约锁员工薪资核算问题	契约锁员工薪资核算问题
契约锁员工工资有问题找谁咨询？	契约锁员工薪资核算问题
怎么处理契约锁员工工资问题？	契约锁员工薪资核算问题
契约锁员工薪资核算有错误找谁？	契约锁员工薪资核算问题
oracle环境，进度字段类型，仍展示中文，可以解决吗	oracle环境，进度字段类型，仍展示中文，可以解决吗
请问环境出问题了联系谁？	请问环境出问题了联系谁？
测试环境有问题找谁处理？	请问环境出问题了联系谁？
测试环境出错咨询谁？	请问环境出问题了联系谁？
部署测试环境授权报错问题如何解决	请问环境出问题了联系谁？
系统环境出问题了	请问环境出问题了联系谁？
请问测试环境出问题了联系谁？	请问环境出问题了联系谁？
系统环境出问题了怎么办	请问环境出问题了联系谁？
ecology8开发环境出问题了	请问环境出问题了联系谁？
督办任务提醒都提醒给哪些人	督办任务提醒都提醒给哪些人
我们系统支持哪些财务系统的凭证集成	我们系统支持哪些财务系统的凭证集成
我们系统支持哪些银行的银企直连接口的凭证集成	我们系统支持哪些财务系统的凭证集成
微搜在哪里控制可搜索的模块	微搜在哪里控制可搜索的模块
项目业绩核算有问题找谁？	项目业绩核算有问题找谁？
项目业绩核算数据出问题找谁？	项目业绩核算有问题找谁？
谁负责项目业绩核算	项目业绩核算有问题找谁？
预算编制的时候提交审批报错，提示没有权限	预算编制的时候提交审批报错，提示没有权限
明天有一批新入职人员前来报道，请安排接待	明天有一批新入职人员前来报道，请安排接待
我们组有新人要来，等会儿接待一下	明天有一批新入职人员前来报道，请安排接待
明天上午有一批新入职员工来上班，安排一下	明天有一批新入职人员前来报道，请安排接待
请安排接待一下后天上午新来的员工	明天有一批新入职人员前来报道，请安排接待
帮忙接待周五新来的同事	明天有一批新入职人员前来报道，请安排接待
新同事要来了，请接待一下	明天有一批新入职人员前来报道，请安排接待
下周一我们部门有三个新来的，请安排一下接待	明天有一批新入职人员前来报道，请安排接待
新入职人员来了，快点安排一下	明天有一批新入职人员前来报道，请安排接待
能不能安排一下，明天有两个新来的员工	明天有一批新入职人员前来报道，请安排接待
接待新同事入职	明天有一批新入职人员前来报道，请安排接待
新同事第一天来需要接待	明天有一批新入职人员前来报道，请安排接待
文档相关表说明	文档相关表说明
统一待办中心功能介绍可以咨询你吗	统一待办中心功能介绍可以咨询你吗
谁是北方大区副总经理	谁是北方大区副总经理
外部邮箱配置了之后一直报错，外部邮件该怎么配置呐？	外部邮箱配置了之后一直报错，外部邮件该怎么配置呐？
页面设计找谁	页面设计找谁
督办详情中默认共享，添加共享的值无法保存是什么原因	督办详情中默认共享，添加共享的值无法保存是什么原因
公司资料申请	公司资料申请
帮我发起一个分部资料申请流程	公司资料申请
申请会展资料	公司资料申请
拿一份活动资料	公司资料申请
我要申请公司去年的培训资料	公司资料申请
我要申请拿一下公司的模块资料	公司资料申请
湖南三正电子的资料我可以申领查看吗	公司资料申请
我要申请资产资料	公司资料申请
我要申请公司纳税的资料	公司资料申请
我要申请一下礼品资料	公司资料申请
请问公司印刷资料相关素材如何申请，走什么流程	公司资料申请
流程中承担主体不显示	流程中承担主体不显示
我要修改什么默认设置项，在系统哪张表？	我要修改什么默认设置项，在系统哪张表？
流程测试需要修改什么默认设置？	我要修改什么默认设置项，在系统哪张表？
流程测试修改默认设置的数据标在哪里？	我要修改什么默认设置项，在系统哪张表？
流程在什么位置修改默认设置项？	我要修改什么默认设置项，在系统哪张表？
云商店e9客户端前置出问题怎么办	云商店e9客户端前置出问题怎么办
登录页面问题	登录页面问题
集成登录页面不显示用户名密码怎么办	登录页面问题
客户端单点到ecology进入到登录页面，单点异常	登录页面问题
e8系统，怎么修改e7登录页面	登录页面问题
系统页面打不开是什么问题	登录页面问题
e-office公司，产品资质有哪些？	e-office公司，产品资质有哪些？
e-office公司和产品资质的列表拿给我看看？	e-office公司，产品资质有哪些？
客户寄来需归档的合同收到了吗？	客户寄来需归档的合同收到了吗？
新客户的需归档的合同寄过来了吗？	客户寄来需归档的合同收到了吗？
需归档的合同收到了吗？	客户寄来需归档的合同收到了吗？
客户的需归档合同怎么还没到？	客户寄来需归档的合同收到了吗？
帮我找一下客户寄来的需归档合同	客户寄来需归档的合同收到了吗？
客户的需归档合同寄到了吗？	客户寄来需归档的合同收到了吗？
客户寄来的需归档合同是谁签收的？	客户寄来需归档的合同收到了吗？
谁负责接收客户寄来的需归档合同	客户寄来需归档的合同收到了吗？
老客户合同审核/合同预审	老客户合同审核/合同预审
老客户合同怎么审核？	老客户合同审核/合同预审
老客户的合同审核了吗？	老客户合同审核/合同预审
老客户的合同预审了吗？	老客户合同审核/合同预审
老客户的合同审核通过了吗？	老客户合同审核/合同预审
老客户合同审核的相关问题咨询谁？	老客户合同审核/合同预审
老客户合同预审的相关问题联系谁呢？	老客户合同审核/合同预审
老客户的合同审核有什么问题吗？	老客户合同审核/合同预审
在收款未结算表中写未立项是什么情况？	在收款未结算表中写未立项是什么情况？
收款未结算表中的未立项是什么意思？	在收款未结算表中写未立项是什么情况？
收款未结算表中的未立项是指什么？	在收款未结算表中写未立项是什么情况？
收款未结算表中的未立项意味着什么？	在收款未结算表中写未立项是什么情况？
收款未结算表中的未立项说明什么？	在收款未结算表中写未立项是什么情况？
收款未结算表中写未立项是什么原因？	在收款未结算表中写未立项是什么情况？
收款未结算表中写未立项是因为什么？	在收款未结算表中写未立项是什么情况？
为什么在收款未结算表中还有未立项这一项？	在收款未结算表中写未立项是什么情况？
文案找谁	文案找谁
询问e-cology最新的标准解决方案、行业解决方案、产品白皮书	询问e-cology最新的标准解决方案、行业解决方案、产品白皮书
文档能限制分享功能吗？	文档能限制分享功能吗？
文档可以限制分享功能吗？	文档能限制分享功能吗？
文档是不是能限制分享功能？	文档能限制分享功能吗？
我用文档限制分享功能是不是可行	文档能限制分享功能吗？
分享功能被文档限制吗？	文档能限制分享功能吗？
文档限制分享功能ok？	文档能限制分享功能吗？
想要把邮件导出eml到本地，一定要启用eml吗？	想要把邮件导出eml到本地，一定要启用eml吗？
应用如何用建模构建	应用如何用建模构建
应用如何用建模做到	应用如何用建模构建
应用怎么用建模发挥作用	应用如何用建模构建
苹果端word文档有些打不开？	苹果端word文档有些打不开？
ios word文档有些打不开？	苹果端word文档有些打不开？
苹果端word有的东西打不开？	苹果端word文档有些打不开？
苹果端word文档有些打开错误？	苹果端word文档有些打不开？
苹果端word文档有些无法打开？	苹果端word文档有些打不开？
哪里找系统日志表	哪里找系统日志表
咱们系统的日志表是哪个？	哪里找系统日志表
ecology有哪些功能	ecology有哪些功能
ecology功能结构有文档吗	ecology有哪些功能
ecology功能结构文档在哪里找	ecology有哪些功能
ecology功能结构图的相关文档有吗	ecology有哪些功能
前端，督办导入，英文下登录，操作说明为何没有展示为英文	前端，督办导入，英文下登录，操作说明为何没有展示为英文
我要离职	我要离职
小e，我想离职	我要离职
你好，帮我办一下离职手续	我要离职
我觉得这份工作不太适合我，因此想离职	我要离职
我要辞职啊 	我要离职
我要离职，因为一些个人原因	我要离职
这个职位跟我想的不太一样，我想辞职	我要离职
我下周就要离开公司了，帮我办理一下离职手续吧	我要离职
员工报销和供应商付款管理能否对接银企直联系统，进行自动化结算?	员工报销和供应商付款管理能否对接银企直联系统，进行自动化结算?
节点操作者可以选择明细人力资源字段吗	节点操作者可以选择明细人力资源字段吗
某个功能页面需要设置什么权限	某个功能页面需要设置什么权限
ecology中的邮件模块中，外部邮箱设置的是只接收最近30天的邮件，但是，系统依旧接收的全部邮件，请问怎么解决	ecology中的邮件模块中，外部邮箱设置的是只接收最近30天的邮件，但是，系统依旧接收的全部邮件，请问怎么解决
公司的活动安排找谁解决	公司的活动安排找谁解决
组织一下下个月初公司技术部和客服部要去团建	公司的活动安排找谁解决
请给安排下个月我们团建的各项事宜	公司的活动安排找谁解决
组织一下年会的节目	公司的活动安排找谁解决
公司的运动会什么时候举行	公司的活动安排找谁解决
谁负责公司的活动安排	公司的活动安排找谁解决
项目验收核算问题找谁？	项目验收核算问题找谁？
项目验收能否核算	项目验收核算问题找谁？
向谁提出项目验收？	项目验收核算问题找谁？
需要看历史验收报告	项目验收核算问题找谁？
android原生与h5页面的的交互	android原生与h5页面的的交互
安卓原生与h5页面的交互	android原生与h5页面的的交互
安卓原生和h5页面的交互	android原生与h5页面的的交互
安卓原生与h5页面的交互界面	android原生与h5页面的的交互
考试流程视频在哪里找	考试流程视频在哪里找
考试流程视频可以发一下吗	考试流程视频在哪里找
人事基础信息分部、部门、人员岗位和其他第3方系统集成有什么接口文档提供	人事基础信息分部、部门、人员岗位和其他第3方系统集成有什么接口文档提供
电子文件如何实现纸质输出并具备法律效力？	电子文件如何实现纸质输出并具备法律效力？
电子文件在打印后是如何保证法律效力的	电子文件如何实现纸质输出并具备法律效力？
已经删除的协作交流和评论还可以查看吗？	已经删除的协作交流和评论还可以查看吗？
请问户外广告设计，应该找谁，走什么流程	请问户外广告设计，应该找谁，走什么流程
门户外广告设计支持找谁？	请问户外广告设计，应该找谁，走什么流程
契约锁员工费用报销怎么处理	契约锁员工费用报销怎么处理
契约锁报销问题找谁咨询	契约锁员工费用报销怎么处理
契约锁员工报销相关问题	契约锁员工费用报销怎么处理
如何处理契约锁员工费用报销？	契约锁员工费用报销怎么处理
入住问题找谁	入住问题找谁
我要订酒店，客户要住	入住问题找谁
给客户预定周三到周五的住宿	入住问题找谁
找一下公司附近近一点的酒店	入住问题找谁
帮客户预订四星级酒店	入住问题找谁
明天的客户住宿怎么安排	入住问题找谁
下周的客户住宿预定	入住问题找谁
订一个这附近比较好的酒店	入住问题找谁
预定交通便利的酒店	入住问题找谁
客户要住在安静的地方	入住问题找谁
客户住的地方附近要有餐厅	入住问题找谁
明天出差帮我安排一下住宿	入住问题找谁
客户住宿	入住问题找谁
demo搭建考试时间安排	demo搭建考试时间安排
这个月最近的一次demo考核是什么时候的，我想参加	demo搭建考试时间安排
近期demo考核安排在什么时候？	demo搭建考试时间安排
最近什么时候有demo考试？	demo搭建考试时间安排
考核版本跟总部备案不一致找谁	考核版本跟总部备案不一致找谁
版本问题	考核版本跟总部备案不一致找谁
客户要方案找谁	客户要方案找谁
客户想要方案	客户要方案找谁
windows过期找谁	windows过期找谁
系统内核算项目相关的业务数据问题	系统内核算项目相关的业务数据问题
系统内核算有问题找谁咨询？	系统内核算项目相关的业务数据问题
产假多少天怎么请	产假多少天怎么请
还有两个月要生小孩了，产假怎么请啊	产假多少天怎么请
我要请个产假，告诉我怎么请	产假多少天怎么请
产假有多少天，怎么请	产假多少天怎么请
请告诉我如何请产假	产假多少天怎么请
我想请产假，应该怎么做	产假多少天怎么请
我们公司请产假的流程是怎样的，给我说一下	产假多少天怎么请
帮我查查怎么请产假，一般能请几天	产假多少天怎么请
我要推荐	我要推荐
如何推荐	我要推荐
怎么推荐	我要推荐
推荐的方法	我要推荐
到哪里推荐	我要推荐
推荐的渠道	我要推荐
如何内推	我要推荐
我希望推荐	我要推荐
云商店网站网址？	云商店网站网址？
下午有个算法工程师来面试，帮忙接待下	下午有个算法工程师来面试，帮忙接待下
面试的新人去哪个会议室等候	下午有个算法工程师来面试，帮忙接待下
今天应聘的人已经到公司，安排面试	下午有个算法工程师来面试，帮忙接待下
面试者被安排在101会议室	下午有个算法工程师来面试，帮忙接待下
明天来面试的新人统一安排在101大会议室	下午有个算法工程师来面试，帮忙接待下
面试的人今天早上就到了，安排一下	下午有个算法工程师来面试，帮忙接待下
今天下午面试java的人到了，安排一下	下午有个算法工程师来面试，帮忙接待下
面试算法的工程师到了，安排一下面试	下午有个算法工程师来面试，帮忙接待下
面试java的同学到了	下午有个算法工程师来面试，帮忙接待下
替我接待一下今天来面试的人	下午有个算法工程师来面试，帮忙接待下
刚刚参加面试的应聘者到了，需要去接待一下	下午有个算法工程师来面试，帮忙接待下
今天面试的人已经到了，帮我接待一下	下午有个算法工程师来面试，帮忙接待下
泛微网络一般纳税人资格证明	泛微网络一般纳税人资格证明
查找相关人员的资格证明	泛微网络一般纳税人资格证明
我想看一下公司一般纳税人的信息规定	泛微网络一般纳税人资格证明
泛微纳税人资格证明	泛微网络一般纳税人资格证明
公司一般纳税人资格证明	泛微网络一般纳税人资格证明
我们公司一般纳税人资格证明怎么开	泛微网络一般纳税人资格证明
泛微网络一般纳税人资格证明在哪里开	泛微网络一般纳税人资格证明
公积金怎么查询	公积金怎么查询
公积金怎么查来着	公积金怎么查询
小e，你知道住房公积金在哪查不	公积金怎么查询
你是不是知道公积金怎么查，给我说一下	公积金怎么查询
我要查询我的住房公积金还有多少钱	公积金怎么查询
请帮我查查看我的公积金有多少呀	公积金怎么查询
我想看看我的公积金账户有多少钱，怎么看	公积金怎么查询
你知道在哪能查住房公积金呀	公积金怎么查询
手机端附件不能下载问题找谁解决	手机端附件不能下载问题找谁解决
丧假有多少天	丧假有多少天
查一下我有多少天丧假	丧假有多少天
我要看看我的丧假额度	丧假有多少天
我还有多少天丧假	丧假有多少天
我的丧假额度用完了吗	丧假有多少天
我要申请请丧假，可以吗	丧假有多少天
查一下我有没有丧假，有几天	丧假有多少天
小e，帮我看看我的丧假天数	丧假有多少天
如何关闭快捷搜索中的微搜？	如何关闭快捷搜索中的微搜？
新建板块页面，格式不对怎么解决	新建板块页面，格式不对怎么解决
我希望参与一场外部活动对我们有价值，我想参与进去，不知道怎么合作？	我希望参与一场外部活动对我们有价值，我想参与进去，不知道怎么合作？
怎么参与外部活动	我希望参与一场外部活动对我们有价值，我想参与进去，不知道怎么合作？
如何合作参与外部联盟的活动	我希望参与一场外部活动对我们有价值，我想参与进去，不知道怎么合作？
想参与一场对我们有价值的外部活动，怎么做	我希望参与一场外部活动对我们有价值，我想参与进去，不知道怎么合作？
oa流程接口文档说明	oa流程接口文档说明
督查督办任务台账构件咨询找谁	督查督办任务台账构件咨询找谁
外勤签到和人事考勤签到是否有结合进行关联。	外勤签到和人事考勤签到是否有结合进行关联。
预算变更流程提交后预算没有发生变化	预算变更流程提交后预算没有发生变化
edge浏览器打开pdf提示安装控件，安装后也无效是为何	edge浏览器打开pdf提示安装控件，安装后也无效是为何
组织架构变更？	组织架构变更？
他们和我说我们组被重组了？	组织架构变更？
1组和2组合并了？	组织架构变更？
我们组的项目改了负责人变了	组织架构变更？
两个组合并之后框架会变得	组织架构变更？
我们部门要改变组织结构了吗	组织架构变更？
部门更改组织架构	组织架构变更？
更改一下部门的组织框架	组织架构变更？
我觉得我们部门的组织架构有点混乱，想调整一下	组织架构变更？
我想稍微调整一下部门的组织架构	组织架构变更？
我们公司的组织架构有点不太合理，请调整一下	组织架构变更？
怎么调整公司的组织架构，我想调整	组织架构变更？
这样的组织不适合，我要调整一下本部门的组织架构	组织架构变更？
目前公司的组织存在混乱，我希望对此进行初步调整	组织架构变更？
小e，我要稍微调一下部门的组织架构，要找谁	组织架构变更？
钉钉相关问题	钉钉相关问题
钉钉问题找谁	钉钉相关问题
契约锁的产品都有哪些？	契约锁的产品都有哪些？
契约锁有哪些特色？	契约锁的产品都有哪些？
流程配置相关问题	流程配置相关问题
流程功能实现有问题找事咨询？	流程配置相关问题
流程功能无法实现配置问题可以找谁？	流程配置相关问题
流程功能和配置相关问题找谁？	流程配置相关问题
流程配置相关问题找谁咨询？	流程配置相关问题
流程配置有问题导致功能无法实现找谁？	流程配置相关问题
请问正式系统配置相关功能找谁？	流程配置相关问题
流程配置找谁	流程配置相关问题
e-cology系统有好多个人的建议，我该怎么来提	e-cology系统有好多个人的建议，我该怎么来提
e-office开票走哪个流程？	e-office开票走哪个流程？
如果我想了解泛微专家能够提供哪些支持，擅长哪些方面，有哪些成功案例，应该找谁协助	如果我想了解泛微专家能够提供哪些支持，擅长哪些方面，有哪些成功案例，应该找谁协助
泛微专家有哪些？	如果我想了解泛微专家能够提供哪些支持，擅长哪些方面，有哪些成功案例，应该找谁协助
泛微专家都能提供哪些支持？	如果我想了解泛微专家能够提供哪些支持，擅长哪些方面，有哪些成功案例，应该找谁协助
泛微专家擅长什么方面？	如果我想了解泛微专家能够提供哪些支持，擅长哪些方面，有哪些成功案例，应该找谁协助
泛微专家各自负责什么方面？	如果我想了解泛微专家能够提供哪些支持，擅长哪些方面，有哪些成功案例，应该找谁协助
契约锁能代理吗	契约锁能代理吗
契约锁允许代理吗？	契约锁能代理吗
契约锁可以申请代理商吗？	契约锁能代理吗
契约锁能代理分销吗？	契约锁能代理吗
契约锁销售能代理吗？	契约锁能代理吗
我要调岗转岗	我要调岗转岗
这个职位不太适合我，可以给我调换岗位吗	我要调岗转岗
我希望能调岗到管理阶层	我要调岗转岗
你好，我想调到财务部	我要调岗转岗
我想做行政，不知道可不可以帮我调到这个职位	我要调岗转岗
请帮我申请调岗	我要调岗转岗
我已经在公司工作五年了，可以调我做经理吗	我要调岗转岗
可以调岗的话，帮我申请一下	我要调岗转岗
我觉得做产品挺适合我，我可以调去做产品吗	我要调岗转岗
我要调到人事了，帮我办理一下相关手续	我要调岗转岗
我想转去做开发的工作	我要调岗转岗
这个职位不太适合我，可以给我转岗吗	我要调岗转岗
我希望能转岗做测试	我要调岗转岗
你好，我想转做会计	我要调岗转岗
小e，帮我申请换岗位	我要调岗转岗
我想做行政，不知道可不可以转去这个职位	我要调岗转岗
启信宝如何集成	启信宝如何集成
页面有乱码怎么办	页面有乱码怎么办
网页出现乱码	页面有乱码怎么办
谁负责处理乱码问题	页面有乱码怎么办
各种乱码编码问题	页面有乱码怎么办
微搜功能支持pdf中的内容作为关键字被搜索出来吗	微搜功能支持pdf中的内容作为关键字被搜索出来吗
我要表扬	我要表扬
我要表扬一下同事	我要表扬
移动部的同事帮我们解决了大问题，我想表扬他	我要表扬
李林工作认真负责，应该表扬	我要表扬
他这个项目做得非常完美，值得表扬	我要表扬
申请一下，我要发起表扬	我要表扬
我申请表扬我们组的开发	我要表扬
怎么申请表扬，我想表扬同事	我要表扬
张毅签约了一个客户，我要表扬他	我要表扬
请问如何自学产品相关的知识？	请问如何自学产品相关的知识？
怎么自学产品相关的内容？	请问如何自学产品相关的知识？
产品相关的知识有教程吗？	请问如何自学产品相关的知识？
产品内容怎么可以自己学习？	请问如何自学产品相关的知识？
升级到了0401版本，今天发现web版的em7都不显示了是什么原因	升级到了0401版本，今天发现web版的em7都不显示了是什么原因
流程异常找谁	流程异常找谁
我是一名实施工程如何转为项目经理	我是一名实施工程如何转为项目经理
e-office支持程序和数据库分离吗？	e-office支持程序和数据库分离吗？
e-office可以用程序还要数据库分离吗？	e-office支持程序和数据库分离吗？
程式还有数据库分离可以在e-office上实现吗？	e-office支持程序和数据库分离吗？
e-office的程序和数据库可以分开部署吗	e-office支持程序和数据库分离吗？
合同业绩中20180999是什么合同？	合同业绩中20180999是什么合同？
合同业绩中20180999是什么意思？	合同业绩中20180999是什么合同？
合同业绩中20180999是指什么？	合同业绩中20180999是什么合同？
合同业绩中20180999意味着什么？	合同业绩中20180999是什么合同？
合同业绩中20180999说明什么？	合同业绩中20180999是什么合同？
合同业绩中20180999这一项是哪里来的？	合同业绩中20180999是什么合同？
我不太明白合同业绩中20180999的意思？	合同业绩中20180999是什么合同？
合同业绩中为什么会有20180999这一项？	合同业绩中20180999是什么合同？
e9系统，听云检测出系统异常怎么解决	e9系统，听云检测出系统异常怎么解决
压测相关问题	压测相关问题
我们有压力测试软件使用教程吗	压测相关问题
我们有压测的接口文档吗	压测相关问题
我们压测的注册用户数、在线用户数、并发用户数是怎么换算的	压测相关问题
谁是陕西大区总经理	谁是陕西大区总经理
契约锁售后服务	契约锁售后服务
契约锁有没有售后	契约锁售后服务
契约锁的售后谁负责	契约锁售后服务
谁负责契约锁售后事宜	契约锁售后服务
您这边有介绍我们公司的vcr 吗？发我一下	您这边有介绍我们公司的vcr 吗？发我一下
泛微宣传视频有吗？	您这边有介绍我们公司的vcr 吗？发我一下
泛微公司的宣传vcr联系谁？	您这边有介绍我们公司的vcr 吗？发我一下
公司宣传片找谁要？	您这边有介绍我们公司的vcr 吗？发我一下
介绍公司的视频去哪里找？	您这边有介绍我们公司的vcr 吗？发我一下
云桥能干什么？	云桥能干什么？
介绍一下云桥	云桥能干什么？
什么是云桥	云桥能干什么？
云桥是什么东西	云桥能干什么？
契约锁单体章怎么卖？	契约锁单体章怎么卖？
客户开票相关问题	客户开票相关问题
我们给客户发票可以开哪些内容，应该怎么开，有些什么差别，开票金额和付款金额有些什么要求	客户开票相关问题
怎么给客户开发票？	客户开票相关问题
客户发票有什么内容？	客户开票相关问题
给客户开发票有什么要求？	客户开票相关问题
客户的开票金额和付款金额有什么需要注意的？	客户开票相关问题
如何通过移动建模引擎实现个性化配置？	如何通过移动建模引擎实现个性化配置？
客户反馈刷新页面会偶发性出现被强制登出的现象怎么解决？	客户反馈刷新页面会偶发性出现被强制登出的现象怎么解决？
我要申请笔记本电脑自用补贴	我要申请笔记本电脑自用补贴
关于笔记本自用补贴的金额是怎么规定的啊	我要申请笔记本电脑自用补贴
我可以领多少笔记本自用补贴	我要申请笔记本电脑自用补贴
我自己带了笔记本电脑，怎么申请补贴	我要申请笔记本电脑自用补贴
我没有用公司的电脑，我可以申请公司的笔记本自用补贴吗	我要申请笔记本电脑自用补贴
我上班用自己的电脑所以想申请笔记本自用补贴	我要申请笔记本电脑自用补贴
我现在上班用的是自己带的电脑，这样公司会有补贴吗	我要申请笔记本电脑自用补贴
公司关于笔记本自用补贴可以怎么申请啊	我要申请笔记本电脑自用补贴
e-office常见的内部平台访问地址有哪些？	e-office常见的内部平台访问地址有哪些？
e-office有哪些访问地址？	e-office常见的内部平台访问地址有哪些？
e-office内部平台内部端口有啥？	e-office常见的内部平台访问地址有哪些？
解释下流程触发集成	解释下流程触发集成
资产模块支持数据关联授权的需求说明有吗	资产模块支持数据关联授权的需求说明有吗
督查督办任务台账构件有问题要找谁	督查督办任务台账构件有问题要找谁
需要云商店相关案例有吗？	需要云商店相关案例有吗？
ebu产品的新功能咨询	ebu产品的新功能咨询
客户想快速了解一下微博邮件功能找谁？	客户想快速了解一下微博邮件功能找谁？
系统登录支持手机号码或者编号(工号)登录吗。	系统登录支持手机号码或者编号(工号)登录吗。
外部邮件在手机端怎么不会进行邮件提醒呐？	外部邮件在手机端怎么不会进行邮件提醒呐？
部署相关问题	部署相关问题
集群部署谁负责	部署相关问题
系统部署相关问题	部署相关问题
weblogic、webspher部署问题	部署相关问题
硬件部署咨询找谁	部署相关问题
系统部署起不来了	部署相关问题
移动端网络和外网不通如何部署移动服务	部署相关问题
系统是否支持ipv6	部署相关问题
系统是否支持tomcat	部署相关问题
系统是否支持docker	部署相关问题
我更换授权，重启服务之后，还是这个报错，我应该找谁处理	部署相关问题
我要部署系统	部署相关问题
我要给客户部署系统	部署相关问题
用户数功能模块价格市场价多少？	用户数功能模块价格市场价多少？
用户数功能模块投放到市场值多少钱？	用户数功能模块价格市场价多少？
用户数这个功能完成要多少钱	用户数功能模块价格市场价多少？
公司实现用户数功能模块要多少钱？	用户数功能模块价格市场价多少？
开票时间	开票时间
开发票写当天吗	开票时间
几号能把发票开出来	开票时间
发票什么最快时候能够开好	开票时间
开发票麻烦吗，需要多久能开好	开票时间
发票什么最快多久能够开好	开票时间
发票什么最快多长时间能够开好	开票时间
谁是长沙ebu六部总经理	谁是长沙ebu六部总经理
无犯罪记录怎么查询	无犯罪记录怎么查询
无犯罪记录如何查询	无犯罪记录怎么查询
看下无犯罪记录	无犯罪记录怎么查询
怎么看无犯罪记录	无犯罪记录怎么查询
哪里可以看到无犯罪记录	无犯罪记录怎么查询
找谁要无犯罪记录	无犯罪记录怎么查询
如何查询无犯罪记录	无犯罪记录怎么查询
无犯罪记录怎么查	无犯罪记录怎么查询
能否支持按部门、个人、费用科目维度的管理费用及按项目维度的预算导入？	能否支持按部门、个人、费用科目维度的管理费用及按项目维度的预算导入？
有客户需要参加培训，我该找谁来处理	有客户需要参加培训，我该找谁来处理
近期的客户培训活动是什么时候？	有客户需要参加培训，我该找谁来处理
客户要参加产品培训找谁咨询？	有客户需要参加培训，我该找谁来处理
我想查询最近的客户培训活动找谁？	有客户需要参加培训，我该找谁来处理
最近的一次客户培训是几号？	有客户需要参加培训，我该找谁来处理
流程监控，指定查看部门流程，设置无效问题如何解决	流程监控，指定查看部门流程，设置无效问题如何解决
云商店流程附件按钮不显示的问题问谁	云商店流程附件按钮不显示的问题问谁
谁是山西大区总经理	谁是山西大区总经理
契约锁集成相关问题	契约锁集成相关问题
e9和契约锁集成场景搭建脚本？	契约锁集成相关问题
ecology集成契约锁功能配置实例？	契约锁集成相关问题
契约锁集成工作是由甲方单独完成吗？	契约锁集成相关问题
契约锁能否与domino系统集成	契约锁集成相关问题
契约锁支持与企业微信集成？需要开发吗？	契约锁集成相关问题
契约锁如何与小程序集成？	契约锁集成相关问题
与企业微信集成后，企业微信的手机号码是不是不能同步到契约锁中？	契约锁集成相关问题
契约锁可以和那些oa厂商集成？	契约锁集成相关问题
我要开账号	我要开账号
我需要开通账号功能	我要开账号
请帮我开通账号	我要开账号
请为我开通账号	我要开账号
能帮我开一下账号功能吗	我要开账号
如何开通账号	我要开账号
开通账号的步骤	我要开账号
可以帮我把账号开通吗	我要开账号
契约锁项目交付问题	契约锁项目交付问题
谁是河南大区总经理	谁是河南大区总经理
移动签到模块无法正常使用是什么原因导致的？	移动签到模块无法正常使用是什么原因导致的？
项目实施成本是多少？	项目实施成本是多少？
项目实施成本是怎么核算的？	项目实施成本是多少？
项目实施成本核算标准是怎样的？	项目实施成本是多少？
项目实施成本如何估计？	项目实施成本是多少？
项目实施成本是按什么标准进行估计的？	项目实施成本是多少？
项目实施成本核算找谁？	项目实施成本是多少？
项目实施是如何进行收费的？	项目实施成本是多少？
项目实施是按什么标准收费的？	项目实施成本是多少？
我们有安可项目案例吗	我们有安可项目案例吗
表单建模/移动建模产品如何提交项目bug、需求开发申请	表单建模/移动建模产品如何提交项目bug、需求开发申请
表单建模/移动建模提交项目bug走什么流程？	表单建模/移动建模产品如何提交项目bug、需求开发申请
表单建模/移动建模需求开发申请走什么流程？	表单建模/移动建模产品如何提交项目bug、需求开发申请
表单建模/移动建模需求开发找谁协助？	表单建模/移动建模产品如何提交项目bug、需求开发申请
表单建模/移动建模到哪里提交系统bug？	表单建模/移动建模产品如何提交项目bug、需求开发申请
表单建模/移动建模如何申请需求开发？	表单建模/移动建模产品如何提交项目bug、需求开发申请
表单建模/移动建模需求开发相关问题找谁咨询？	表单建模/移动建模产品如何提交项目bug、需求开发申请
表单建模到哪里提交系统bug	表单建模/移动建模产品如何提交项目bug、需求开发申请
移动建模到哪里提交系统bug	表单建模/移动建模产品如何提交项目bug、需求开发申请
移动建模需求开发申请走什么流程	表单建模/移动建模产品如何提交项目bug、需求开发申请
移动端附件上传字段是否支持排序和重命名的需求可以实现吗	移动端附件上传字段是否支持排序和重命名的需求可以实现吗
合同发票进度找谁查	合同发票进度找谁查
合同发票进度怎么样了？	合同发票进度找谁查
合同发票进度在哪里可以查询？	合同发票进度找谁查
哪里可以查到合同发票进度？	合同发票进度找谁查
合同发票开好了吗？	合同发票进度找谁查
合同发票找谁？	合同发票进度找谁查
我的合同发票开得怎么样了？	合同发票进度找谁查
合同发票相关问题找谁？	合同发票进度找谁查
满足资产模块支持数据关联授权的需求功能文档有吗	满足资产模块支持数据关联授权的需求功能文档有吗
移动建模产品如何提交项目bug？	移动建模产品如何提交项目bug？
提交移动建模产品项目的bug要如何操作	移动建模产品如何提交项目bug？
应用一打开就闪退	应用一打开就闪退
应用一开就闪退怎么办	应用一打开就闪退
应用闪退咋搞	应用一打开就闪退
应用一开闪退咋办	应用一打开就闪退
非标功能在后台启用后还是看不到功能？	非标功能在后台启用后还是看不到功能？
已经启用了非标功能，但是看不到怎么办	非标功能在后台启用后还是看不到功能？
非标功能启用后该功能不可用	非标功能在后台启用后还是看不到功能？
非合同文件需要盖章走什么流程？	非合同文件需要盖章走什么流程？
非合同文件盖章应该提交什么流程？	非合同文件需要盖章走什么流程？
我需要给非合同文件盖章	非合同文件需要盖章走什么流程？
非合同文件需要盖章如何申请？	非合同文件需要盖章走什么流程？
非合同文件用章怎么走流程？	非合同文件需要盖章走什么流程？
我的一个非合同文件要盖章	非合同文件需要盖章走什么流程？
公司非合同文件盖章如何提流程？	非合同文件需要盖章走什么流程？
非合同文件用章申请怎么提流程？	非合同文件需要盖章走什么流程？
想快速简单了解一下云商店，要找谁？	想快速简单了解一下云商店，要找谁？
有e8升级e9推荐方案吗？	有e8升级e9推荐方案吗？
流程测试相关问题	流程测试相关问题
流程测试里，用某个账号进去，页面空白的这个是哪里未配置吗	流程测试相关问题
流程测试里面可以测试js开发的校验吗	流程测试相关问题
新建测试流程权限是哪个	流程测试相关问题
云桥怎么集成	云桥怎么集成
云桥和钉钉、微信企业号、微信服务号如何集成	云桥怎么集成
云桥和钉钉、微信企业号、微信服务号集成如何实现	云桥怎么集成
云桥和钉钉、微信企业号、微信服务号分别如何集成集成	云桥怎么集成
我要云桥和钉钉、微信企业号、微信服务号集成怎么搞	云桥怎么集成
钉钉系统是否可以和我们做集成	云桥怎么集成
钉钉集成接入配置	云桥怎么集成
云桥怎么集成微信	云桥怎么集成
云桥如何集成微信	云桥怎么集成
目前有没有客户做过云桥和企业微信集成的案例？	云桥怎么集成
有关于集成钉钉的移动考勤方案吗？	云桥怎么集成
emessage聊天信息推送给企业微信；云桥如何配置？	云桥怎么集成
message聊天信息推送给企业微信；云桥该选择哪个推送模块？	云桥怎么集成
云桥怎么集成第三方app	云桥怎么集成
云桥怎么样可以集成第三方app	云桥怎么集成
你们提供系统和数据库维护服务吗?	你们提供系统和数据库维护服务吗?
契约锁测试组	契约锁测试组
找一下契约锁测试人员	契约锁测试组
https相关问题	https相关问题
https的问题找谁能处理	https相关问题
我对https有些疑问，想找人解决一下	https相关问题
升级后的版本是否对接口有影响要找谁	升级后的版本是否对接口有影响要找谁
我们本地有国产化测试环境吗	我们本地有国产化测试环境吗
流程签字意见里这个定位在哪开关	流程签字意见里这个定位在哪开关
通过标准的api修改只读字段，保存不上？	通过标准的api修改只读字段，保存不上？
我奖金错了	我奖金错了
帮我查一下，这个月发的奖金不够	我奖金错了
你看看是谁负责奖金发放的，我这边出了点错	我奖金错了
这个月奖金给我算错了吧	我奖金错了
我上个月的业绩奖金没有发	我奖金错了
请告诉我奖金发的不够怎么办，找谁解决	我奖金错了
你把我的全勤奖算错了	我奖金错了
奖金发放错了怎么办	我奖金错了
请问公司vi系统资料如何提供	请问公司vi系统资料如何提供
公司vi系统资料找谁？	请问公司vi系统资料如何提供
我周末报名值班	我周末报名值班
我想周末来公司值班，帮我报个名	我周末报名值班
申请周末值班	我周末报名值班
请打开周末值班申请	我周末报名值班
你好，我要报名周末值班	我周末报名值班
怎么申请周末值班，帮我报名	我周末报名值班
我周末想来公司值班	我周末报名值班
下周末我要报名来公司值班	我周末报名值班
代理商的日常事务处理及支持工作	代理商的日常事务处理及支持工作
非对称加密的应用场景有哪些	非对称加密的应用场景有哪些
督查督办管理权限监控权限有何区别	督查督办管理权限监控权限有何区别
漏签找谁	漏签找谁
我考勤数据错了	我考勤数据错了
小e，我上周五没有迟到呀，考勤表上显示错误了	我考勤数据错了
我的考勤数据出错了，上个月我没有早退	我考勤数据错了
昨天没有请假，考勤显示错误了	我考勤数据错了
我出差是上周不是这周，考勤表显示的不对	我考勤数据错了
考勤表上显示我请假三天，但我只请了两天，出错了	我考勤数据错了
我早上按时签到了，考勤表错了	我考勤数据错了
考勤表多算了我一天迟到，怎么改呀	我考勤数据错了
你给我改一下，我这周一没有请假	我考勤数据错了
上周一我是外勤签到，考勤表搞错了，说我旷工	我考勤数据错了
昨天我没旷工，我请假了，考勤数据不对	我考勤数据错了
系统显示缺勤怎么办	我考勤数据错了
上周五我请病假了，系统记录为缺勤，该怎么处理	我考勤数据错了
系统显示我缺勤好几天，怎么办	我考勤数据错了
因为请假显示的缺勤数据怎么办	我考勤数据错了
昨天没来上班，系统记我缺勤了一天，怎么办呀	我考勤数据错了
请告诉我如何处理系统里的缺勤数据	我考勤数据错了
请查询一下缺勤怎么办	我考勤数据错了
如果缺勤，我该怎么做	我考勤数据错了
怎么处理系统里的缺勤记录啊	我考勤数据错了
看一下系统里我有缺勤吗，有的话怎么处理	我考勤数据错了
小e，如果缺勤，怎么处理系统数据	我考勤数据错了
系统显示旷工怎么办	我考勤数据错了
系统显示我旷工好几天，怎么办	我考勤数据错了
怎么处理系统里的旷工	我考勤数据错了
我昨天忘记签到，系统显示成旷工了，我该怎么办呀	我考勤数据错了
如果旷工，怎么处理系统数据	我考勤数据错了
前天忘记签到，系统记我旷工了怎么办	我考勤数据错了
e9新考勤是否支持按照不同地理位置就行考勤。	e9新考勤是否支持按照不同地理位置就行考勤。
分叉同时操作，为什么会保存失败？	分叉同时操作，为什么会保存失败？
分叉同时操作，出现保存失败是为什么	分叉同时操作，为什么会保存失败？
为什么分叉同时操作会失败呢	分叉同时操作，为什么会保存失败？
webservice白名单配置	webservice白名单配置
怎么配置webservice的白名单	webservice白名单配置
oracle部署相关问题	oracle部署相关问题
oracle启动会报错	oracle部署相关问题
oracle启动有问题	oracle部署相关问题
oracle启动不了	oracle部署相关问题
oracle启动异常	oracle部署相关问题
oracle搬迁问题	oracle部署相关问题
迁移oracle数据库的问题	oracle部署相关问题
有关oracle迁移问题	oracle部署相关问题
oracle更改地址问题	oracle部署相关问题
oracle迁移上的问题	oracle部署相关问题
oracle迁移出问题了，要找谁	oracle部署相关问题
迁移oracle数据库的时候，报错了	oracle部署相关问题
oracle迁移问题	oracle部署相关问题
oracle初始化错误	oracle部署相关问题
oracle初始化有问题	oracle部署相关问题
甲骨文初始化失败	oracle部署相关问题
云商店流程无法上传附件	云商店流程无法上传附件
我要办理居住证	我要办理居住证
居住证怎么办	我要办理居住证
我来上海工作三年了，可以办居住证吗	我要办理居住证
能给我办个居住证不	我要办理居住证
根据政策，我可以办居住证了，帮我办理一下	我要办理居住证
我要申请办理居住证	我要办理居住证
办居住证要啥材料，给我办一下，我准备材料	我要办理居住证
请帮我申请办理上海的居住证	我要办理居住证
oa的流程表单是否可以转其他文件格式	oa的流程表单是否可以转其他文件格式
oa的流程表单是否可以转pdf？	oa的流程表单是否可以转其他文件格式
报销流程归档后能否直接生成凭证?	报销流程归档后能否直接生成凭证?
页面打开慢	页面打开慢
配置部开发是谁	配置部开发是谁
我找一下配置部开发人员	配置部开发是谁
配置部开发人员	配置部开发是谁
预算数、已发生、审批中数据的查询sql怎么写	预算数、已发生、审批中数据的查询sql怎么写
能帮忙发一下签约新闻吗？	能帮忙发一下签约新闻吗？
签约新闻找谁发布	能帮忙发一下签约新闻吗？
结束状态的协作可以从哪里查看？	结束状态的协作可以从哪里查看？
我想了解特殊激励制度	我想了解特殊激励制度
看下特殊激励制度	我想了解特殊激励制度
查下公司的特殊激励制度	我想了解特殊激励制度
哪里看特殊激励制度	我想了解特殊激励制度
特殊激励制度的标准	我想了解特殊激励制度
我符合特殊激励制度吗	我想了解特殊激励制度
怎么看特殊激励制度	我想了解特殊激励制度
搜索特殊激励制度	我想了解特殊激励制度
收款相关问题	收款相关问题
怎么显示收款金额	收款相关问题
收款看不到金额，是什么原因	收款相关问题
收款看不到金额，看不到项目收款，客服收款是为什么	收款相关问题
收款看不到金额，看不到项目收款，客服收款是什么情况	收款相关问题
看不到项目收款是什么原因	收款相关问题
看不到客服收款是什么原因	收款相关问题
看不到客服收款是为什么	收款相关问题
看不到客服收款是为何	收款相关问题
看不到项目收款和金额是什么原因	收款相关问题
收款看不到金额，看不到项目收款，客服收款是什么原因	收款相关问题
收款无法查看金额是什么原因？	收款相关问题
收款没有金额是怎么回事？	收款相关问题
没有收款金额是怎么回事？	收款相关问题
运营相关问题	运营相关问题
我账号被锁定了	我账号被锁定了
我账号被锁定了，怎么解决	我账号被锁定了
账号被锁定如何处理	我账号被锁定了
账号突然被锁定了	我账号被锁定了
我账号怎么被锁了啊	我账号被锁定了
账号被锁了找谁解决啊	我账号被锁定了
请问如何解决账号被锁问题	我账号被锁定了
账号被锁了，有解决方法吗	我账号被锁定了
我公司的账号被锁了，现在需要处理下	我账号被锁定了
泛微与契约锁目前集成了那些功能？	泛微与契约锁目前集成了那些功能？
安全包等该怎么打？	安全包等该怎么打？
流程特批找谁	流程特批找谁
正文转pdf为什么不成功	正文转pdf为什么不成功
访问服务器失败找谁	访问服务器失败找谁
访问服务器失败怎么办	访问服务器失败找谁
我们的系统的功能满足不了客户的需求，但客户坚持要开发，该找谁来处理	我们的系统的功能满足不了客户的需求，但客户坚持要开发，该找谁来处理
客户要开发找谁处理？	我们的系统的功能满足不了客户的需求，但客户坚持要开发，该找谁来处理
客户坚持要做开发咨询谁？	我们的系统的功能满足不了客户的需求，但客户坚持要开发，该找谁来处理
系统不能满足客户需求找谁协助？	我们的系统的功能满足不了客户的需求，但客户坚持要开发，该找谁来处理
公司的logo我需要一份源文件，在哪里？	公司的logo我需要一份源文件，在哪里？
谁有公司的logo源文件	公司的logo我需要一份源文件，在哪里？
我要办一个市场活动，但是以前从没有办过或参加过，我应该向谁咨询	我要办一个市场活动，但是以前从没有办过或参加过，我应该向谁咨询
市场活动策划找谁咨询？	我要办一个市场活动，但是以前从没有办过或参加过，我应该向谁咨询
举办市场活动联系谁？	我要办一个市场活动，但是以前从没有办过或参加过，我应该向谁咨询
市场活动举办向谁了解？	我要办一个市场活动，但是以前从没有办过或参加过，我应该向谁咨询
谁对办活动比较熟悉？	我要办一个市场活动，但是以前从没有办过或参加过，我应该向谁咨询
小e怎么部署？	小e怎么部署？
如何部署小e？	小e怎么部署？
小e部署相关问题找谁咨询？	小e怎么部署？
小e部署需要什么配置？	小e怎么部署？
小e如何配置部署环境？	小e怎么部署？
正式系统流程调整	正式系统流程调整
正式系统流程怎么调整	正式系统流程调整
系统中病毒了找谁	系统中病毒了找谁
系统中毒怎么办？	系统中病毒了找谁
处理病毒的安全专家？	系统中病毒了找谁
系统怎么防范病毒？	系统中病毒了找谁
系统中毒怎么应急？	系统中病毒了找谁
计算机病毒怎么处理？	系统中病毒了找谁
我的系统中毒了	系统中病毒了找谁
系统中毒，服务器被黑了	系统中病毒了找谁
客户碰到勒索病毒怎么解决？	系统中病毒了找谁
客户反馈中了勒索病毒找谁？	系统中病毒了找谁
谁能处理勒索病毒？	系统中病毒了找谁
系统勒索病毒相关安全专家？	系统中病毒了找谁
客户退款相关问题	客户退款相关问题
合同废除后，如何退回客户的首付款	客户退款相关问题
合同解除要申请退款	客户退款相关问题
客户与我们毁约，钱款可以退还吗	客户退款相关问题
公司与客户的合同终止了，怎么走退货款的流程	客户退款相关问题
客户说产品不好,要退款	客户退款相关问题
客户申请退款	客户退款相关问题
客户不满意产品要退钱	客户退款相关问题
客户把需求改少了,申请退款	客户退款相关问题
退款给客户	客户退款相关问题
要给客户退款怎么办	客户退款相关问题
退款的钱找谁拿	客户退款相关问题
客户货款多付了要退款	客户退款相关问题
客户的贷款额度多了需要退款	客户退款相关问题
客户多付的货款什么时候能退还	客户退款相关问题
客户货款多付了要退款如何处理	客户退款相关问题
我们的e-office产品的demo系统无法访问，怎么办	我们的e-office产品的demo系统无法访问，怎么办
纳税社保在哪查询	纳税社保在哪查询
看下纳税社保	纳税社保在哪查询
怎么看纳税社保	纳税社保在哪查询
哪里可以看到纳税社保	纳税社保在哪查询
找谁要纳税社保	纳税社保在哪查询
如何查询纳税社保	纳税社保在哪查询
纳税社保怎么查	纳税社保在哪查询
我要查询纳税社保	纳税社保在哪查询
分支机构渠道方面（包括伙伴）的有关协调事宜	分支机构渠道方面（包括伙伴）的有关协调事宜
分支机构找谁咨询？	分支机构渠道方面（包括伙伴）的有关协调事宜
谁了解分支机构有关的事宜	分支机构渠道方面（包括伙伴）的有关协调事宜
怎么实现云桥集成轻推显示出待办/抄送的未读数呢？	怎么实现云桥集成轻推显示出待办/抄送的未读数呢？
工资条未收到	工资条未收到
工资条没发吗 	工资条未收到
工资条没拿到啊	工资条未收到
工资条发了没	工资条未收到
我还没收到工资条	工资条未收到
工资条还未拿到	工资条未收到
工资条并没有收到	工资条未收到
没收到工资条啊	工资条未收到
契约锁产品如何管理企业印章	契约锁产品如何管理企业印章
契约锁产品是怎么管理印章的？	契约锁产品如何管理企业印章
如何管理契约锁的企业印章？	契约锁产品如何管理企业印章
契约锁产品是怎么管理公司印章的？	契约锁产品如何管理企业印章
公司印章你们是怎么管理？	契约锁产品如何管理企业印章
你们管理公司用印的方案是怎样的？	契约锁产品如何管理企业印章
契约锁的权限是如何管理的？	契约锁产品如何管理企业印章
如果用契约锁管理企业印章的	契约锁产品如何管理企业印章
系统分权的问题	系统分权的问题
我忘带key了	我忘带key了
我没有带key	我忘带key了
忘带key怎么办	我忘带key了
今天没有带key哎	我忘带key了
啊我今天忘带key了	我忘带key了
我忘记带key严重吗，怎么办啊	我忘带key了
真傻，今天忘记带key了	我忘带key了
我没想起来要带key，怎么办啊	我忘带key了
查看日志的高级搜索条件样式不对如何解决	查看日志的高级搜索条件样式不对如何解决
我要发布招聘信息	我要发布招聘信息
如何发布招聘信息	我要发布招聘信息
请帮我发布招聘信息	我要发布招聘信息
怎么发布招聘信息啊	我要发布招聘信息
在哪里发布招聘信息啊	我要发布招聘信息
发布招聘信息有哪些渠道啊	我要发布招聘信息
我想发下公司的招聘信息	我要发布招聘信息
想要发一些招聘信息	我要发布招聘信息
招聘信息一般都要怎么发布啊	我要发布招聘信息
我希望发布一些招聘信息	我要发布招聘信息
公司的招聘信息要怎么发布啊	我要发布招聘信息
我想招人	我要发布招聘信息
如何招人	我要发布招聘信息
怎么招人	我要发布招聘信息
到哪里招人	我要发布招聘信息
去哪儿招人	我要发布招聘信息
e-todo坏了找谁	e-todo坏了找谁
下级目录无法新建找谁解决？	下级目录无法新建找谁解决？
开通e-office账号	开通e-office账号
我需要在本地申请装一套e-office产品的demo系统，该怎么做	我需要在本地申请装一套e-office产品的demo系统，该怎么做
云商店明细插件联动不出来怎么解决	云商店明细插件联动不出来怎么解决
移动引擎能否实现可视化图标控件？	移动引擎能否实现可视化图标控件？
ecology安装找谁	ecology安装找谁
e7安装失败	ecology安装找谁
字段联动插件通过主表字段联动明细表数据，当流程退回到发起节点后，之前联动出来的数据会被清空是什么问题	字段联动插件通过主表字段联动明细表数据，当流程退回到发起节点后，之前联动出来的数据会被清空是什么问题
申请licence授权，最终用户编号哪里能查到？	申请licence授权，最终用户编号哪里能查到？
如何查询licence授权的用户编号	申请licence授权，最终用户编号哪里能查到？
请把licence的申请编号给我	申请licence授权，最终用户编号哪里能查到？
我想看一下licence授权的编号	申请licence授权，最终用户编号哪里能查到？
使用licence后查看标号	申请licence授权，最终用户编号哪里能查到？
查看我的licence编码	申请licence授权，最终用户编号哪里能查到？
licence申请结果查看	申请licence授权，最终用户编号哪里能查到？
申请licence授权，哪里能查到用户编号？	申请licence授权，最终用户编号哪里能查到？
领用一些资产	领用一些资产
笔用完了领一个	领用一些资产
领两瓶白酒	领用一些资产
领取一支笔	领用一些资产
领一个本子做笔记	领用一些资产
领一个插线板	领用一些资产
领一箱矿泉水	领用一些资产
领用办公室电话	领用一些资产
领用圆珠笔	领用一些资产
拿两瓶白酒嗯放在前台等一会我5点半来拿	领用一些资产
办公用品申请	领用一些资产
我要领两瓶酒	领用一些资产
领用一台电话	领用一些资产
领用茅台	领用一些资产
领笔记本	领用一些资产
公司有没有数据线	领用一些资产
资产领用	领用一些资产
申请电脑电源线	领用一些资产
申请一个插线板	领用一些资产
领网线	领用一些资产
你可以帮我申请一个新的笔记本吗	领用一些资产
申请资产	领用一些资产
申领资产	领用一些资产
我要牛皮纸小信封	领用一些资产
谁是ebu本部总经理兼副总裁	谁是ebu本部总经理兼副总裁
公司的总经理是谁来着	谁是ebu本部总经理兼副总裁
我们公司的副总裁是谁	谁是ebu本部总经理兼副总裁
谁是副总裁	谁是ebu本部总经理兼副总裁
这个客户安装出现了问题怎么处理？	这个客户安装出现了问题怎么处理？
客户安装出问题了	这个客户安装出现了问题怎么处理？
客户安装系统失败	这个客户安装出现了问题怎么处理？
谁解决客户安装失败的问题	这个客户安装出现了问题怎么处理？
oa申请了非标准功能【统一待办中心】，第3方系统要如何将待办消息推送到oa？	oa申请了非标准功能【统一待办中心】，第3方系统要如何将待办消息推送到oa？
oa的待办流程是否可以推送到第3方系统（含app），如何实现，有接口吗？	oa申请了非标准功能【统一待办中心】，第3方系统要如何将待办消息推送到oa？
oa的待办流程怎么推送到第三方系统	oa申请了非标准功能【统一待办中心】，第3方系统要如何将待办消息推送到oa？
第三方如何推送待办消息到oa	oa申请了非标准功能【统一待办中心】，第3方系统要如何将待办消息推送到oa？
消息接口问题	消息接口问题
消息接口找谁要	消息接口问题
如何修改密码？	如何修改密码？
系统密码忘了怎么修改·？	如何修改密码？
我的账号被盗了要修改密码	如何修改密码？
修改密码要找系统管理员吗	如何修改密码？
如何成为契约锁的代理商	如何成为契约锁的代理商
成为契约锁代理商需要经过哪些流程？	如何成为契约锁的代理商
契约锁代理需要经过哪些步骤？	如何成为契约锁的代理商
怎样才能成为契约锁代理商？	如何成为契约锁的代理商
契约锁代理合作找谁咨询？	如何成为契约锁的代理商
契约锁代理伙伴咨询谁？	如何成为契约锁的代理商
督查督办成文对模板有什么要求？	督查督办成文对模板有什么要求？
vss谁负责	vss谁负责
外部人员是否占用license数	外部人员是否占用license数
项目实施过程文档盖章走什么流程？	项目实施过程文档盖章走什么流程？
项目实施过程文档需要盖章走什么流程？	项目实施过程文档盖章走什么流程？
我需要项目实施过程文档盖章	项目实施过程文档盖章走什么流程？
项目实施过程文档需要盖章如何申请	项目实施过程文档盖章走什么流程？
项目实施过程文档用章怎么走流程	项目实施过程文档盖章走什么流程？
我的这个项目实施过程文档要盖章	项目实施过程文档盖章走什么流程？
公司项目实施过程文件盖章如何提流程	项目实施过程文档盖章走什么流程？
项目实施过程文档用章申请怎么提流程	项目实施过程文档盖章走什么流程？
我办公室的空调坏了	我办公室的空调坏了
我的椅子都破了	我办公室的空调坏了
打印机有问题	我办公室的空调坏了
灯具坏了	我办公室的空调坏了
门坏了	我办公室的空调坏了
报修	我办公室的空调坏了
空调有问题	我办公室的空调坏了
灯不亮了，找师傅修理一下	我办公室的空调坏了
灯不亮	我办公室的空调坏了
投影仪出问题了，赶紧找人看一下	我办公室的空调坏了
空调坏了，找一下维修师傅吧	我办公室的空调坏了
窗户破了，找人修理一下	我办公室的空调坏了
能帮忙看下142会议室的遥控器吗？好像没反应	我办公室的空调坏了
修一下202会议室的门把手	我办公室的空调坏了
修一下会议室的椅子	我办公室的空调坏了
行政报修	我办公室的空调坏了
你好，4楼c区这里往下滴水的问题啥时候给修下呢，每隔3-4分钟就会滴一次，不小心衣服和座椅就会被打湿	我办公室的空调坏了
跳闸了	我办公室的空调坏了
断电了	我办公室的空调坏了
我的座位没有电	我办公室的空调坏了
停电了	我办公室的空调坏了
e-office实施过程中如何搭建外网访问oa系统？	e-office实施过程中如何搭建外网访问oa系统？
怎么样在e-office中跳过内网访问oa系统？	e-office实施过程中如何搭建外网访问oa系统？
oa系统是不是可以通过外网在e-office的过程中来实现？	e-office实施过程中如何搭建外网访问oa系统？
客户是否可以单独购买考勤功能而不购买e-cology	客户是否可以单独购买考勤功能而不购买e-cology
正版sql server2012企业版大概是多少钱	正版sql server2012企业版大概是多少钱
sql server2012企业版正版数据库 大概需要多少钱	正版sql server2012企业版大概是多少钱
银行承兑汇票如何核算业绩	银行承兑汇票如何核算业绩
客户用支付宝转账怎么核算销售业绩	银行承兑汇票如何核算业绩
支票付款可以算在业绩里面吗	银行承兑汇票如何核算业绩
支票付款会算在业绩里面吗	银行承兑汇票如何核算业绩
支票付款如何算业绩	银行承兑汇票如何核算业绩
支票付款怎么算业绩	银行承兑汇票如何核算业绩
银行承兑汇票怎么核算业绩	银行承兑汇票如何核算业绩
银行承兑汇票可以核算业绩吗	银行承兑汇票如何核算业绩
e9系统授权到期了，泽哥，找谁处理	e9系统授权到期了，泽哥，找谁处理
我要转户口	我要转户口
我想转户口	我要转户口
我的户口不在上海，可以给我转过来吗	我要转户口
申请迁户口	我要转户口
你好，我要把我的户口迁过来	我要转户口
我的户口在江苏，能不能给我转到上海	我要转户口
小e，请帮我申请转移户口	我要转户口
怎么申请转移户口呀	我要转户口
可以转户口吗，帮我申请一下	我要转户口
售前讲标	售前讲标
已经成功交付的客户有投诉找谁	已经成功交付的客户有投诉找谁
交付客户的投诉找谁咨询？	已经成功交付的客户有投诉找谁
已经交付的客户投诉找谁协助？	已经成功交付的客户有投诉找谁
成功客户投诉联系谁？	已经成功交付的客户有投诉找谁
交付客户投诉相关问题找谁？	已经成功交付的客户有投诉找谁
已交付的客户投诉如何处理？	已经成功交付的客户有投诉找谁
我的快递到哪里了	我的快递到哪里了
看看我的快递到哪里了	我的快递到哪里了
我昨天寄出去的客户资料到哪里了	我的快递到哪里了
昨天寄给合肥分公司的资料今天到了吗	我的快递到哪里了
帮我查一下这个快递现在到哪里了	我的快递到哪里了
寄给合肥的快递什么时候签收	我的快递到哪里了
昨天江苏公司寄给我的资料今天到了吗	我的快递到哪里了
我的快递要是到了帮我签收一下	我的快递到哪里了
帮我查一查我的快递	我的快递到哪里了
小e帮我查一下我昨天寄给河北周扬的快递到哪里	我的快递到哪里了
小e帮我看看河北河阳寄给我的资料到哪里了	我的快递到哪里了
查询快递	我的快递到哪里了
昨天我买的书今天到了吗	我的快递到哪里了
e9集成钉钉，流程消息推送到钉钉时，钉钉消息提醒的标题中增加了"\"符号是什么原因？	e9集成钉钉，流程消息推送到钉钉时，钉钉消息提醒的标题中增加了"\"符号是什么原因？
客户管理，车辆管理产品咨询，配置，需求相关问题？	客户管理，车辆管理产品咨询，配置，需求相关问题？
客户管理产品需求相关问题找谁？	客户管理，车辆管理产品咨询，配置，需求相关问题？
车辆管理产品需求相关问题找谁？	客户管理，车辆管理产品咨询，配置，需求相关问题？
客户管理产品配置相关问题找谁？	客户管理，车辆管理产品咨询，配置，需求相关问题？
车辆管理产品配置相关问题找谁？	客户管理，车辆管理产品咨询，配置，需求相关问题？
客户管理产品相关问题找谁？	客户管理，车辆管理产品咨询，配置，需求相关问题？
流程流转条件判断走向不对会是什么原因？	流程流转条件判断走向不对会是什么原因？
默认流程提醒生日功能如何设置	默认流程提醒生日功能如何设置
借用资质证书原件走什么流程	借用资质证书原件走什么流程
我需要借用资质证书原件，请帮我提下流程	借用资质证书原件走什么流程
借用资质证书原件如何申请	借用资质证书原件走什么流程
借用资质证书原件走哪个流程	借用资质证书原件走什么流程
请帮我借用资质证书原件	借用资质证书原件走什么流程
公司借用资质证书原件如何提流程	借用资质证书原件走什么流程
借用资质证书原件怎么提流程	借用资质证书原件走什么流程
借用资质证书原件要怎么申请啊	借用资质证书原件走什么流程
e9新考勤是否支持弹性制考勤。	e9新考勤是否支持弹性制考勤。
近期卖点考试安排在什么时候呀？	近期卖点考试安排在什么时候呀？
销售卖点考试安排找谁？	近期卖点考试安排在什么时候呀？
最近的卖点考试安排？	近期卖点考试安排在什么时候呀？
最近什么时候有销售卖点考试？	近期卖点考试安排在什么时候呀？
申请电脑找谁	申请电脑找谁
oa中集成契约锁	oa中集成契约锁
契约锁与oa进行集成	oa中集成契约锁
契约锁与e9进行集成	oa中集成契约锁
e9中集成契约锁	oa中集成契约锁
二开问题	二开问题
二开	二开问题
二次开发问题	二开问题
二开咨询谁	二开问题
e-ffice10.0 内部系统外发如何配置?	e-ffice10.0 内部系统外发如何配置?
e-ffice10.0 内部系统外发要什么配置文件?	e-ffice10.0 内部系统外发如何配置?
备案找谁	备案找谁
签订合同时，哪些算第三方采购，哪些属于常规二次销售，哪些属于增值二次销售	签订合同时，哪些算第三方采购，哪些属于常规二次销售，哪些属于增值二次销售
合同类型找谁咨询？	签订合同时，哪些算第三方采购，哪些属于常规二次销售，哪些属于增值二次销售
什么是第三方采购合同？	签订合同时，哪些算第三方采购，哪些属于常规二次销售，哪些属于增值二次销售
什么是常规二次销售合同？	签订合同时，哪些算第三方采购，哪些属于常规二次销售，哪些属于增值二次销售
什么是增值二次销售？	签订合同时，哪些算第三方采购，哪些属于常规二次销售，哪些属于增值二次销售
与我相关，切换tab没有加载中的效果是为何	与我相关，切换tab没有加载中的效果是为何
云桥会务系统访问地址是？	云桥会务系统访问地址是？
预算模块-财务做账这边操作对象，选择不了是为什么	预算模块-财务做账这边操作对象，选择不了是为什么
客户想参加泛微产品培训，怎么能查询到近期的客户培训安排呢？	客户想参加泛微产品培训，怎么能查询到近期的客户培训安排呢？
我需要英文翻译，应该找谁	我需要英文翻译，应该找谁
英文翻译找谁负责？	我需要英文翻译，应该找谁
谁负责英文翻译？	我需要英文翻译，应该找谁
你知道英文翻译找谁吗？	我需要英文翻译，应该找谁
我想咨询英文翻译应该找谁？	我需要英文翻译，应该找谁
系统登录支持那些安全登录方式。	系统登录支持那些安全登录方式。
mobile的考勤功能是否是标准的	mobile的考勤功能是否是标准的
moboile是否支持集群	moboile是否支持集群
moboile支持集群吗	moboile是否支持集群
可以对moboile建立集群吗	moboile是否支持集群
广州大区总经理是谁	广州大区总经理是谁
什么是第三方电子签约平台？	什么是第三方电子签约平台？
e-offce登录如何设置？	e-offce登录如何设置？
e-offce的登录是不是要初始化设置？	e-offce登录如何设置？
e-offce登录是不是要配置文件？	e-offce登录如何设置？
数据库有没有什么优化的方案	数据库有没有什么优化的方案
客户是cology签约的还是office签约的？	客户是cology签约的还是office签约的？
这个客户在哪签到合同？	客户是cology签约的还是office签约的？
我看下这个客户的签约信息？	客户是cology签约的还是office签约的？
如何集成第三方h5应用？	如何集成第三方h5应用？
怎么集成第三方h5应用？	如何集成第三方h5应用？
如何合并第三方h5应用？	如何集成第三方h5应用？
要怎么可以集成第三方h5应用？	如何集成第三方h5应用？
为什么修改留痕，修订者的信息显示为word登录账号	为什么修改留痕，修订者的信息显示为word登录账号
系统登录支持内外网隔离登录吗。	系统登录支持内外网隔离登录吗。
客户的款到了吗？剩余多少没有付？客户收款在哪里可以查看到？	客户的款到了吗？剩余多少没有付？客户收款在哪里可以查看到？
我要看客户收款报表	客户的款到了吗？剩余多少没有付？客户收款在哪里可以查看到？
客户还欠我们多少钱	客户的款到了吗？剩余多少没有付？客户收款在哪里可以查看到？
我们这个客户是不是钱还没付完	客户的款到了吗？剩余多少没有付？客户收款在哪里可以查看到？
客户欠多少钱能查看吗	客户的款到了吗？剩余多少没有付？客户收款在哪里可以查看到？
我的客户还有多少款没付清	客户的款到了吗？剩余多少没有付？客户收款在哪里可以查看到？
系统中的ecology专区的系统改进建议中具体功能应用清单有哪些？	系统中的ecology专区的系统改进建议中具体功能应用清单有哪些？
云商店显示异常问题	云商店显示异常问题
云商店界面显示异常问题	云商店显示异常问题
云商店界面存在显示异常现象怎么办	云商店显示异常问题
云商店页面出现异常了	云商店显示异常问题
已发生、审批中费用能在哪里查询到	已发生、审批中费用能在哪里查询到
请问预算周期指的什么，设置每月或每季度有什么影响吗	请问预算周期指的什么，设置每月或每季度有什么影响吗
我想索要e-officedemo系统中的数据，该怎么处理	我想索要e-officedemo系统中的数据，该怎么处理
合同原件可以外借吗	合同原件可以外借吗
可以外借合同原件吗	合同原件可以外借吗
公司同意把合同原件外借吗	合同原件可以外借吗
可以把合同原件借给我吗	合同原件可以外借吗
我能不能借一下合同原件	合同原件可以外借吗
可不可以把合同原件借给客户	合同原件可以外借吗
合同原件能借给我看一下吗	合同原件可以外借吗
客户要查看合同原件，可以借出去吗	合同原件可以外借吗
有没有销售行业客户的案例？	有没有销售行业客户的案例？
我工资错了	我工资错了
我工资算错了找谁	我工资错了
我工资不正确要怎么办啊	我工资错了
我这个月的薪水发的有问题哎	我工资错了
我工资感觉被财务处算错了	我工资错了
我8月份的薪资一定给我算少了	我工资错了
如果薪资算错了，找那个部门啊	我工资错了
我工资有问题，请问要找谁处理啊	我工资错了
我工资核算少了，应该找财务处核实下吗	我工资错了
请帮我确认下工资，谢谢	我工资错了
你们搞错了我的工资，我需要重新确认	我工资错了
工资发的不正确	我工资错了
工资发错了吧	我工资错了
这工资是不是少发了	我工资错了
工资发少了吧	我工资错了
这工资有问题吧	我工资错了
流程/知识等其他模块的邮件提醒，想要修改提醒模板，怎么修改？	流程/知识等其他模块的邮件提醒，想要修改提醒模板，怎么修改？
在线人员和在线并发数统计逻辑是什么，和emobile是分开的还是包含的。	在线人员和在线并发数统计逻辑是什么，和emobile是分开的还是包含的。
第三方产品试用	第三方产品试用
永中试用找谁	第三方产品试用
谁负责帆软试用	第三方产品试用
金格试用怎么操作	第三方产品试用
动态令牌怎么试用	第三方产品试用
我想使用服务器	第三方产品试用
我想试用电脑找谁	第三方产品试用
怎么试用手机	第三方产品试用
视频会议系统试用	第三方产品试用
考勤模块找谁	考勤模块找谁
申请产品纸质宣传资料走什么流程？	申请产品纸质宣传资料走什么流程？
我要提交产品宣传资料需求流程	申请产品纸质宣传资料走什么流程？
海报的产品宣传有没有案例给我看看	申请产品纸质宣传资料走什么流程？
谁负责系统架构？	谁负责系统架构？
系统架构找谁？	谁负责系统架构？
系统架构知识找谁的？	谁负责系统架构？
架构问题	谁负责系统架构？
一个客户使用两套系统怎么备案？	一个客户使用两套系统怎么备案？
我们客户想用两套系统怎么处理	一个客户使用两套系统怎么备案？
客户有两套系统应该怎么去备案	一个客户使用两套系统怎么备案？
我要领结婚礼物	我要领结婚礼物
今年我准备结婚，公司会有什么福利吗	我要领结婚礼物
公司对自己员工结婚这块有什么福利吗	我要领结婚礼物
我下周就结婚了，公司有什么礼物赠送的吗	我要领结婚礼物
我今年准备结婚，公司有什么相对应的员工福利吗	我要领结婚礼物
公司对员工结婚会提供哪些福利啊	我要领结婚礼物
我想看看我的结婚礼物是什么	我要领结婚礼物
公司会给我什么样的结婚礼物啊	我要领结婚礼物
流程组负责人	流程组负责人
流程组负责人是谁	流程组负责人
谁领导流程组	流程组负责人
网站被屏蔽找谁	网站被屏蔽找谁
我们公司的美工是谁	我们公司的美工是谁
谁是华南二部总经理	谁是华南二部总经理
我要投诉	我要投诉
我很生气，我要投诉	我要投诉
客户那边出问题了，我要投诉负责人	我要投诉
我想投诉负责这次活动的人员	我要投诉
客户服务态度太差，应该投诉他	我要投诉
因为他的疏忽导致出了大错误，我必须投诉他	我要投诉
请帮我申请一下，我要投诉客户部的李林	我要投诉
给我投诉万达的客户负责人	我要投诉
新员工产品考试流程有哪些	新员工产品考试流程有哪些
正式系统上，单页协作下，参与情况里面的图标和字重叠了怎么解决	正式系统上，单页协作下，参与情况里面的图标和字重叠了怎么解决
契约锁目前招聘岗位有哪些	契约锁目前招聘岗位有哪些
契约锁目前有哪些职位空缺	契约锁目前招聘岗位有哪些
契约锁有岗位空缺吗？	契约锁目前招聘岗位有哪些
契约锁有哪些岗位正在招人？	契约锁目前招聘岗位有哪些
督查督办数据导入不成功怎么办？	督查督办数据导入不成功怎么办？
oa升级后文档日志无法显示是什么原因	oa升级后文档日志无法显示是什么原因
预算科目中关联对象选择的是项目有什么作用	预算科目中关联对象选择的是项目有什么作用
这个方案哪些客户用？	这个方案哪些客户用？
谁是海南大区总经理	谁是海南大区总经理
流程功能包开发进度咨询谁？	流程功能包开发进度咨询谁？
流程功能包测试进度找谁咨询？	流程功能包开发进度咨询谁？
流程功能有问题找谁？	流程功能包开发进度咨询谁？
老客户合同邮寄给谁？	老客户合同邮寄给谁？
怎么寄老客户的合同	老客户合同邮寄给谁？
谁负责收寄送老客户的合同	老客户合同邮寄给谁？
谁知道老客户的合同怎么寄	老客户合同邮寄给谁？
邮寄老客户的合同，接收人是谁	老客户合同邮寄给谁？
老客户寄合同应该寄给谁	老客户合同邮寄给谁？
老客户的合同要寄给谁	老客户合同邮寄给谁？
请告诉我老客户的合同应该邮寄给谁	老客户合同邮寄给谁？
你知道老客户的合同可以邮寄给谁吗	老客户合同邮寄给谁？
我要在本机搭建一套系统，要怎么获得安装盘	我要在本机搭建一套系统，要怎么获得安装盘
本地搭建系统怎么申请安装盘？	我要在本机搭建一套系统，要怎么获得安装盘
本地系统需要安装盘找谁咨询？	我要在本机搭建一套系统，要怎么获得安装盘
本地系统安装盘在哪里获取？	我要在本机搭建一套系统，要怎么获得安装盘
本地系统怎么获取安装盘？	我要在本机搭建一套系统，要怎么获得安装盘
后台开启了附件。但是前台刷新后，仍无上传附件功能怎么办	后台开启了附件。但是前台刷新后，仍无上传附件功能怎么办
公司资质在哪查询	公司资质在哪查询
公司资质在哪里查询	公司资质在哪查询
看下公司资质	公司资质在哪查询
怎么看公司资质	公司资质在哪查询
哪里可以看到公司资质	公司资质在哪查询
找谁要公司资质	公司资质在哪查询
如何查询公司资质	公司资质在哪查询
公司资质怎么查	公司资质在哪查询
我签约了新客户或进行了一项活动，要宣传，找谁	我签约了新客户或进行了一项活动，要宣传，找谁
活动宣传找谁咨询？	我签约了新客户或进行了一项活动，要宣传，找谁
活动宣传相关问题可以咨询谁？	我签约了新客户或进行了一项活动，要宣传，找谁
公司谁负责活动宣传相关事宜？	我签约了新客户或进行了一项活动，要宣传，找谁
新客户宣传相关问题找谁咨询？	我签约了新客户或进行了一项活动，要宣传，找谁
客户想关闭部分流程接口怎么办	客户想关闭部分流程接口怎么办
开发环境搭建找谁？	开发环境搭建找谁？
文档涉及的表有哪些	文档涉及的表有哪些
e-office10.0 流程出口条件设置过程中需要注意的一些事项？	e-office10.0 流程出口条件设置过程中需要注意的一些事项？
误操作完成的督办任务如何重新开启	误操作完成的督办任务如何重新开启
客户系统扫描出漏洞，需要进行渗透测试	客户系统扫描出漏洞，需要进行渗透测试
客户系统有漏洞怎么解决？	客户系统扫描出漏洞，需要进行渗透测试
客户系统渗透测试找谁？	客户系统扫描出漏洞，需要进行渗透测试
客户系统需要进行渗透测试找谁协助？	客户系统扫描出漏洞，需要进行渗透测试
客户系统有漏洞找谁测试？	客户系统扫描出漏洞，需要进行渗透测试
谁负责修复客户系统漏洞？	客户系统扫描出漏洞，需要进行渗透测试
我希望与某个厂商建立战略合作关系，具体怎么处理？	我希望与某个厂商建立战略合作关系，具体怎么处理？
我想更换系统信息	我想更换系统信息
我的系统信息好像不对，帮我修改一下	我想更换系统信息
系统里我的个人介绍帮我换一下	我想更换系统信息
公司系统里我的个人信息的性别弄错了	我想更换系统信息
系统里怎么我的入职时间不对啊	我想更换系统信息
公司新系统上的我的手机号写错了	我想更换系统信息
我刚刚发现系统里我的年龄信息不对啊	我想更换系统信息
小e你能帮我修改一下系统信息吗	我想更换系统信息
请你帮我看看我的系统信息对不对	我想更换系统信息
知识地图--知识点，新建知识点，选择文档时候，通过搜索条件的文档目录去查询，跳出的界面为何是报错的界面	知识地图--知识点，新建知识点，选择文档时候，通过搜索条件的文档目录去查询，跳出的界面为何是报错的界面
项目上是否做过案例	项目上是否做过案例
新建文档目录窗口，必填项标识展示位置不贴合的问题找谁	新建文档目录窗口，必填项标识展示位置不贴合的问题找谁
移动管理平台	移动管理平台
移动管理平台的问题找谁处理	移动管理平台
流程流转相关问题	流程流转相关问题
流程流转设定这里，是不是只能添加处理节点？不能添加审核节点？	流程流转相关问题
可以设置不打印流程流转意见吗	流程流转相关问题
流程流转到正文可编辑节点，节点操作者没有编辑按钮	流程流转相关问题
做了流程权限转移，哪些信息会被修改	流程流转相关问题
流程转发有几种设置方式啊	流程流转相关问题
你们的流程流转有几种方式?	流程流转相关问题
转发的流程，设置了不提交，但是在消息中点开查看后，还是停留在待处理的界面中？	流程流转相关问题
报表功能需要采购哪个第三方	报表功能需要采购哪个第三方
ie无法预览个别pdf问题支持问题怎么解决	ie无法预览个别pdf问题支持问题怎么解决
pdf无法在线预览	ie无法预览个别pdf问题支持问题怎么解决
oa是否可以与多个ad域集成，能否实现多域用户登录认证，多域的组织架构和人员信息同步到oa这样的需求？	oa是否可以与多个ad域集成，能否实现多域用户登录认证，多域的组织架构和人员信息同步到oa这样的需求？
各版本产品功能不熟悉，想了解有哪些差别	各版本产品功能不熟悉，想了解有哪些差别
什么是公钥和私钥？	什么是公钥和私钥？
oa正式系统问题找谁？	oa正式系统问题找谁？
请问产品演示考核通过的标准是什么？	请问产品演示考核通过的标准是什么？
怎么样算通过产品演示考核	请问产品演示考核通过的标准是什么？
产品演示考核有哪些考点？	请问产品演示考核通过的标准是什么？
产品演示考核达标要符合哪些要求？	请问产品演示考核通过的标准是什么？
产品演示考核通过需具备什么？	请问产品演示考核通过的标准是什么？
系统集成方面的技术咨询	系统集成方面的技术咨询
如果客户想做oa与考勤系统的集成，我们应该怎么考虑哪几方面?	系统集成方面的技术咨询
人员合同签订流程是否可以跟异构系统集成，集成如何实现?	系统集成方面的技术咨询
oa系统要和很多系统集成，接口是免费提供的吗?	系统集成方面的技术咨询
开放平台可以和哪些应用集成?	系统集成方面的技术咨询
永中部署完以后与oa系统集成的相关配置项	系统集成方面的技术咨询
首页的外部数据元素中,这个已有数据集成是什么地方设置的	系统集成方面的技术咨询
对于财务凭证集成的需求，应该注意哪些问题?	系统集成方面的技术咨询
系统集成方面的技术问题	系统集成方面的技术咨询
档案管理系统集成问题	系统集成方面的技术咨询
如何与第三方的档案管理系统集成?	系统集成方面的技术咨询
客户的集成问题	系统集成方面的技术咨询
异构系统集成可以实现	系统集成方面的技术咨询
如果要与异构系统集成的话，你们可以实现吗	系统集成方面的技术咨询
客户有集成方面的问题需要找人咨询	系统集成方面的技术咨询
如何集成	系统集成方面的技术咨询
用户手册，白皮书等技术资料找谁	用户手册，白皮书等技术资料找谁
指导手册找谁	用户手册，白皮书等技术资料找谁
后台手册找谁	用户手册，白皮书等技术资料找谁
操作手册找谁	用户手册，白皮书等技术资料找谁
我要一份用户手册	用户手册，白皮书等技术资料找谁
写邮件的时候，附件上传按钮，不能用了，怎么办？	写邮件的时候，附件上传按钮，不能用了，怎么办？
我要换个笔记本电脑	我要换个笔记本电脑
帮我换一个新一点的笔记本电脑吧，下午要演示ppt呢	我要换个笔记本电脑
这台笔记本电脑太卡了，帮我换一台比较新的	我要换个笔记本电脑
这台笔记本坏了都，换一下	我要换个笔记本电脑
我明天去恒大公司，帮我换一台新的性能比较的笔记本电脑	我要换个笔记本电脑
我上个月借的笔记本电脑太破了，帮我换一台	我要换个笔记本电脑
小e，帮我换一下笔记本电脑	我要换个笔记本电脑
我昨天领的笔记本电脑有点旧了，帮我换一台吧	我要换个笔记本电脑
我要办理贷款	我要办理贷款
我上个月刚买了房，现在要办理贷款	我要办理贷款
公司可以帮我办理一下贷款吗	我要办理贷款
我明天来公司可以办理贷款吗	我要办理贷款
我的贷款什么时候可以办下来啊	我要办理贷款
我办理贷款还要提供哪些材料啊	我要办理贷款
我办理贷款的材料还缺什么啊	我要办理贷款
我上个月提交的办理贷款申请什么事实可以批下来	我要办理贷款
会议演示需要用激光笔，请准备好	会议演示需要用激光笔，请准备好
借我个u盘，急用	会议演示需要用激光笔，请准备好
我现在着急用照相机，快帮我借一个	会议演示需要用激光笔，请准备好
能不能借一个投影机	会议演示需要用激光笔，请准备好
我手机坏了，借我一个应急用	会议演示需要用激光笔，请准备好
借我个优盘，急用	会议演示需要用激光笔，请准备好
有没有测试用的手机，我要借下	会议演示需要用激光笔，请准备好
有没有投影仪，我临时借用下	会议演示需要用激光笔，请准备好
最新反馈时间，英文下登录没有展示为英文的问题	最新反馈时间，英文下登录没有展示为英文的问题
我要制作工牌	我要制作工牌
补办工作牌找谁	我要制作工牌
考勤同步设置，签到时间为必填是什么原因？	考勤同步设置，签到时间为必填是什么原因？
eoffice开发人员有哪些	eoffice开发人员有哪些
在哪里可以查看到契约锁案例？	在哪里可以查看到契约锁案例？
契约锁案例找谁提供？	在哪里可以查看到契约锁案例？
契约锁案例包装找谁？	在哪里可以查看到契约锁案例？
契约锁都有哪些场景的案例？	在哪里可以查看到契约锁案例？
契约锁包装过哪些客户？	在哪里可以查看到契约锁案例？
契约锁有相关行业的案例吗？	在哪里可以查看到契约锁案例？
契约锁案例包装找谁咨询？	在哪里可以查看到契约锁案例？
契约锁都有哪些案例实践？	在哪里可以查看到契约锁案例？
云商店e9的应用场景有哪些？	云商店e9的应用场景有哪些？
国产化支持哪些服务器	国产化支持哪些服务器
国产化支持飞腾服务器吗	国产化支持哪些服务器
国产化支持华为服务器吗	国产化支持哪些服务器
国产化支持兆芯服务器吗	国产化支持哪些服务器
国产化支持海光服务器吗	国产化支持哪些服务器
国产化支持申威服务器吗	国产化支持哪些服务器
国产化支持麒麟服务器吗	国产化支持哪些服务器
国产化支持鲲鹏服务器吗	国产化支持哪些服务器
国产化支持安可服务器吗	国产化支持哪些服务器
督办类型，英文下登录，消息中心提醒标签名称为何没有展示为英文	督办类型，英文下登录，消息中心提醒标签名称为何没有展示为英文
契约锁实名认证有问题找谁？	契约锁实名认证有问题找谁？
进行个人实名认证填写姓名和手机号，系统提示无效手机号或提示填写信息与实名认证信息不符，无法进行认证是为什么？	契约锁实名认证有问题找谁？
契约锁实名认证无法通过找谁？	契约锁实名认证有问题找谁？
契约锁银行卡认证有问题找谁？	契约锁实名认证有问题找谁？
契约锁做过哪些行业的客户？	契约锁做过哪些行业的客户？
契约锁有海外客户吗？	契约锁做过哪些行业的客户？
我们契约锁客户都分布在哪些行业	契约锁做过哪些行业的客户？
都有哪些行业是我们契约锁的客户	契约锁做过哪些行业的客户？
附件上传的问题要找谁修复	附件上传的问题要找谁修复
我们写过互联网行业或考勤功能的文案吗？	我们写过互联网行业或考勤功能的文案吗？
单点登录集成问题	单点登录集成问题
如果我想知道系统单点登录的接口应该找谁	单点登录集成问题
单点登录问题咨询谁	单点登录集成问题
系统单点登录问题该找谁解决	单点登录集成问题
有关单点登录集成的问题	单点登录集成问题
谁负责单点登录集成问题	单点登录集成问题
第3方系统如何单点登录oa，有几种方式，能提供相应的方案吗？	单点登录集成问题
第三方产品功能	第三方产品功能
动态令牌功能是什么	第三方产品功能
永中功能有哪些	第三方产品功能
帆软功能怎么样	第三方产品功能
问下视频会议系统的功能	第三方产品功能
服务器功能查询	第三方产品功能
帮我查下电脑产品的功能	第三方产品功能
ocr识别具体有哪些功能	第三方产品功能
医药行业分析报告找谁	医药行业分析报告找谁
金格控件兼容问题	金格控件兼容问题
金格控件相关问题该找谁	金格控件兼容问题
谁负责金格控件问题	金格控件兼容问题
谁能解决金格空间问题	金格控件兼容问题
我要办理出国手续签证	我要办理出国手续签证
麻烦你帮我办理一下出国手续签证	我要办理出国手续签证
我下个月要去韩国，要办理一下出国手续签证	我要办理出国手续签证
出国手续签证办理可以找谁啊	我要办理出国手续签证
我今年下半年准备去日本，所以要办一个出国手续签证	我要办理出国手续签证
出国的手续办理有点麻烦	我要办理出国手续签证
我要办理出国的手续需要提前准备哪些材料啊	我要办理出国手续签证
我的出国签证和手续最快需要多久能够办好啊	我要办理出国手续签证
微搜部署失败	微搜部署失败
契约锁这个功能能实现吗？	契约锁这个功能能实现吗？
这个功能契约锁可以实现吗？	契约锁这个功能能实现吗？
这个功能契约锁能做吗？	契约锁这个功能能实现吗？
契约锁这个功能好实现吗？	契约锁这个功能能实现吗？
契约锁功能相关问题找谁咨询？	契约锁这个功能能实现吗？
契约所这个功能能做吗？	契约锁这个功能能实现吗？
契约锁功能需求咨询谁？	契约锁这个功能能实现吗？
契约锁产品可以实现这个吗	契约锁这个功能能实现吗？
契约锁有这个功能吗？	契约锁这个功能能实现吗？
契约锁是否有这个功能？	契约锁这个功能能实现吗？
契约锁这个功能已经有了吗？	契约锁这个功能能实现吗？
这个功能契约锁有吗？	契约锁这个功能能实现吗？
这个功能契约锁能提供吗？	契约锁这个功能能实现吗？
招投标平台注册及账号密码相关问题联系谁？	招投标平台注册及账号密码相关问题联系谁？
招投标平台注册相关问题找谁咨询？	招投标平台注册及账号密码相关问题联系谁？
招投标平台怎么注册账号	招投标平台注册及账号密码相关问题联系谁？
招投标平台账号忘记密码怎么办	招投标平台注册及账号密码相关问题联系谁？
招投标平台什么时候开放	招投标平台注册及账号密码相关问题联系谁？
招投标平台登录不了怎么处理	招投标平台注册及账号密码相关问题联系谁？
招投标平台的相关问题联系谁	招投标平台注册及账号密码相关问题联系谁？
招投标平台登录要走什么流程	招投标平台注册及账号密码相关问题联系谁？
招投标平台怎么进行注册？	招投标平台注册及账号密码相关问题联系谁？
招投标平台需要用什么账号登录	招投标平台注册及账号密码相关问题联系谁？
招投标平台的网址链接是什么	招投标平台注册及账号密码相关问题联系谁？
招投标平台账号密码问题联系谁？	招投标平台注册及账号密码相关问题联系谁？
招投标平台账号多少	招投标平台注册及账号密码相关问题联系谁？
招投标平台账号找谁要	招投标平台注册及账号密码相关问题联系谁？
招投标平台账号密码是啥	招投标平台注册及账号密码相关问题联系谁？
怎么查招投标平台账号和密码	招投标平台注册及账号密码相关问题联系谁？
帮我查招投标平台账号及密码	招投标平台注册及账号密码相关问题联系谁？
无法看到会议	无法看到会议
看不到创建的会议	无法看到会议
会议看不到怎么办	无法看到会议
会议创建了，但是流程清单中看不到会议	无法看到会议
预算相关功能涉及的表结构有么	预算相关功能涉及的表结构有么
会议安排要找谁？	会议安排要找谁？
病假要什么资料	病假要什么资料
要是我请病假的话，需要什么资料呀	病假要什么资料
我们公司规定请病假必备资料有哪些	病假要什么资料
你快点帮我查查请病假要什么资料	病假要什么资料
病假资料有什么，我准备一下	病假要什么资料
我要申请病假，要求有哪些个资料呀	病假要什么资料
公司关于病假有哪些要求和规定	病假要什么资料
我们公司要求病假必须有的资料是什么	病假要什么资料
文件服务转换器是什么	文件服务转换器是什么
文件转换服务器怎么使用	文件服务转换器是什么
文件转换服务器有什么用	文件服务转换器是什么
文件转换服务器有什么作用	文件服务转换器是什么
哪些调查是可以删除的？	哪些调查是可以删除的？
谁是湖北大区总经理	谁是湖北大区总经理
正文的选择框目录怎样才能选择到字段	正文的选择框目录怎样才能选择到字段
电子证书过期找谁咨询？	电子证书过期找谁咨询？
电子证书失效找谁咨询？	电子证书过期找谁咨询？
如何申请转正	如何申请转正
谁是江西大区总经理	谁是江西大区总经理
我想开通流程权限	我想开通流程权限
我需要开通流程权限功能	我想开通流程权限
请帮我开通流程权限	我想开通流程权限
请为我开通流程权限	我想开通流程权限
能帮我开一下流程权限功能吗	我想开通流程权限
如何开通流程权限	我想开通流程权限
开通流程权限的步骤	我想开通流程权限
可以帮我把流程权限开通吗	我想开通流程权限
每月几号可以核对机构结算款？每月几号支付结算跨？	每月几号可以核对机构结算款？每月几号支付结算跨？
每月什么时候和核对机构结算款？	每月几号可以核对机构结算款？每月几号支付结算跨？
每月什么时候支付机构结算款？	每月几号可以核对机构结算款？每月几号支付结算跨？
查一下机构结算款核对时间？	每月几号可以核对机构结算款？每月几号支付结算跨？
帮我查一下机构结算款支付时间？	每月几号可以核对机构结算款？每月几号支付结算跨？
请问机构结算款是什么时候核算的？	每月几号可以核对机构结算款？每月几号支付结算跨？
机构结算款是什么时候支付的？	每月几号可以核对机构结算款？每月几号支付结算跨？
机构结算款什么时候进行核算？	每月几号可以核对机构结算款？每月几号支付结算跨？
协作信息中编辑保存之后显示不正确问题如何解决	协作信息中编辑保存之后显示不正确问题如何解决
系统宕机了找谁?	系统宕机了找谁?
系统宕机了怎么办?	系统宕机了找谁?
我的系统宕机了	系统宕机了找谁?
系统dang机了怎么办?	系统宕机了找谁?
调查里面的授权是用来做什么的？	调查里面的授权是用来做什么的？
新客户合同模版在哪里？	新客户合同模版在哪里？
哪里找新客户合同模板	新客户合同模版在哪里？
谁有新客户合同模板	新客户合同模版在哪里？
新客户合同模板找谁要	新客户合同模版在哪里？
我想要新客户合同模板找谁	新客户合同模版在哪里？
哪里能下载新客户合同模板	新客户合同模版在哪里？
谁有新客户的合同模板	新客户合同模版在哪里？
新客户合同模板怎么下载	新客户合同模版在哪里？
iweboffice	iweboffice
请通知行政部门，明天中午在公司的招待餐厅准备十人的用餐	请通知行政部门，明天中午在公司的招待餐厅准备十人的用餐
嗯请通知行政部明天在公司招待需要预订十人的用餐	请通知行政部门，明天中午在公司的招待餐厅准备十人的用餐
通知行政部门准备明天三个人的用餐	请通知行政部门，明天中午在公司的招待餐厅准备十人的用餐
明天在公司的招待需要预订一个十人的用餐	请通知行政部门，明天中午在公司的招待餐厅准备十人的用餐
今天在公司的招待需要预订十人用餐	请通知行政部门，明天中午在公司的招待餐厅准备十人的用餐
通知行政部门明天准备十人左右的用餐	请通知行政部门，明天中午在公司的招待餐厅准备十人的用餐
通知行政部门明天有一个十个人的午餐	请通知行政部门，明天中午在公司的招待餐厅准备十人的用餐
通知行政部门明天中午有一个十个人的午餐	请通知行政部门，明天中午在公司的招待餐厅准备十人的用餐
江苏省政府明天在公司招待需要预订十人的用餐	请通知行政部门，明天中午在公司的招待餐厅准备十人的用餐
嗯通知行政部门明天准备十人左右的用餐	请通知行政部门，明天中午在公司的招待餐厅准备十人的用餐
通知行政明天十人用餐	请通知行政部门，明天中午在公司的招待餐厅准备十人的用餐
通知行政部门准备十人的用餐	请通知行政部门，明天中午在公司的招待餐厅准备十人的用餐
通知行政部准备十个人的用餐	请通知行政部门，明天中午在公司的招待餐厅准备十人的用餐
我要订餐	请通知行政部门，明天中午在公司的招待餐厅准备十人的用餐
周末订餐	请通知行政部门，明天中午在公司的招待餐厅准备十人的用餐
手机会议新建功能	手机会议新建功能
项目上扣钱了，我想知道扣在哪	项目上扣钱了，我想知道扣在哪
数据库恢复	数据库恢复
数据恢复	数据库恢复
数据库能恢复吗	数据库恢复
婚假多少天怎么请	婚假多少天怎么请
请问，我要请婚假，应该怎么请	婚假多少天怎么请
请告诉我公司关于婚假的制度	婚假多少天怎么请
你知不知道怎么请婚假，我要请	婚假多少天怎么请
下个月我要结婚了，怎么请假	婚假多少天怎么请
请婚假难吗？有什么要求	婚假多少天怎么请
你帮我查一下婚假怎么请	婚假多少天怎么请
我要结婚了，婚假要提前多久请啊	婚假多少天怎么请
我们公司对于请婚假有没有什么规定啊，具体怎么请啊	婚假多少天怎么请
班车相关问题找谁	班车相关问题找谁
班车问题找谁	班车相关问题找谁
谁知道班车在哪乘坐	班车相关问题找谁
班车在哪	班车相关问题找谁
班车几点有	班车相关问题找谁
班车停靠点	班车相关问题找谁
班车运行时间	班车相关问题找谁
合同号怎么查	合同号怎么查
查一下新合同的合同号	合同号怎么查
合同号在哪查询	合同号怎么查
我要查一下合同号要联系谁？	合同号怎么查
我想知道这个合同的合同号	合同号怎么查
这个合同的合同号在哪？	合同号怎么查
合同号可以修改吗？	合同号怎么查
把我签的合同的合同号发给我	合同号怎么查
系统文档迁移方案	系统文档迁移方案
查询结算款	查询结算款
我的结算款还有多少未领取？	查询结算款
还有多少结算款是未领取的？	查询结算款
我的剩余结算款怎么查询的？	查询结算款
在哪里查询我还没有领取的结算款？	查询结算款
在哪里查询我的剩余结算款？	查询结算款
我还有多少结算款没有收到？	查询结算款
没到账的结算款还有多少？	查询结算款
查询剩余结算款找谁？	查询结算款
如何使用客户公海	如何使用客户公海
客户公海是什么	如何使用客户公海
e-office支持配置https协议访问吗？	e-office支持配置https协议访问吗？
https协议可以用在e-office来访问吗	e-office支持配置https协议访问吗？
e-office适配https协议来登录吗	e-office支持配置https协议访问吗？
ssl证书相关问题	ssl证书相关问题
ssl证书是什么	ssl证书相关问题
邮件模块，点击写信的时候，可以默认改为发送内部邮件吗？	邮件模块，点击写信的时候，可以默认改为发送内部邮件吗？
我想了解客户的系统的使用情况，找谁来询问	我想了解客户的系统的使用情况，找谁来询问
客户的系统使用情况怎么了解？	我想了解客户的系统的使用情况，找谁来询问
如何查询客户的系统使用情况？	我想了解客户的系统的使用情况，找谁来询问
客户使用系统的情况怎么查询？	我想了解客户的系统的使用情况，找谁来询问
我怎样可以了解到客户使用系统的情况？	我想了解客户的系统的使用情况，找谁来询问
我能看到客户使用系统的频率吗？	我想了解客户的系统的使用情况，找谁来询问
人才库找谁	人才库找谁
契约锁系统有问题	契约锁系统有问题
契约锁系统有问题找谁咨询？	契约锁系统有问题
契约锁系统有问题联系谁处理？	契约锁系统有问题
契约锁系统有问题找谁解决？	契约锁系统有问题
契约锁系统有问题提交给谁？	契约锁系统有问题
契约锁系统存在问题找谁协助？	契约锁系统有问题
契约锁系统使用寻在问题怎么处理？	契约锁系统有问题
契约锁bug找谁处理？	契约锁系统有问题
契约锁有bug怎么提交？	契约锁系统有问题
契约锁有bug去哪里提交？	契约锁系统有问题
契约锁有bug联系谁解决？	契约锁系统有问题
契约锁有bug怎么解决？	契约锁系统有问题
契约锁bug联系谁解决？	契约锁系统有问题
契约锁bug	契约锁系统有问题
契约锁产品bug	契约锁系统有问题
契约锁功能出错找谁处理？	契约锁系统有问题
契约锁功能出错怎么解决？	契约锁系统有问题
如何验证电子签章有效性？	如何验证电子签章有效性？
如何验证合同文件中的签名及盖章的有效性？或者说如何在打开的阅读器中将签名有效性未知改成显示为签名有效？	如何验证电子签章有效性？
如何验证电子签名有效性？	如何验证电子签章有效性？
电子签名的有效性怎么验证	如何验证电子签章有效性？
谁是上海大区总经理	谁是上海大区总经理
我的电脑坏了	我的电脑坏了
我的电脑网络不通需要维修	我的电脑坏了
当前网络很慢	我的电脑坏了
电话拨不出去	我的电脑坏了
电话出问题了，报修一下	我的电脑坏了
电话断线	我的电脑坏了
网络不通	我的电脑坏了
网络连接不了	我的电脑坏了
电脑坏了	我的电脑坏了
电脑蓝屏	我的电脑坏了
电脑死机	我的电脑坏了
连不上网了	我的电脑坏了
怎么连wifi	我的电脑坏了
局域网连不上了	我的电脑坏了
电脑中毒了	我的电脑坏了
电脑很慢	我的电脑坏了
报修一下电脑	我的电脑坏了
我电脑坏了/慢了	我的电脑坏了
最近几次我的电脑老是蓝屏	我的电脑坏了
帮我看看我的电脑显示器出什么毛病了	我的电脑坏了
我的电脑又卡住了，鼠标也不能动了	我的电脑坏了
我电脑蓝屏了	我的电脑坏了
我电脑怎么突然卡住不能动了	我的电脑坏了
我的电脑最近老是莫名其妙的死机	我的电脑坏了
我的电脑显示屏出现了花纹	我的电脑坏了
我的电脑开不了机了	我的电脑坏了
帮我看看我的电脑为什么不能开机	我的电脑坏了
我电脑的主机按钮好像不能按了	我的电脑坏了
座机坏了	我的电脑坏了
不能上网	我的电脑坏了
键盘坏了找谁	我的电脑坏了
怎么申请显示器	我的电脑坏了
客户需要定制app需要如何处理	客户需要定制app需要如何处理
我要转正	我要转正
小e，我来公司几个月了，想转正	我要转正
我想转为正式员工	我要转正
我实习期已经过了，可以转正了吧	我要转正
我们老大说我可以转正了	我要转正
给我申请转为正式工	我要转正
快点转正啊	我要转正
我要提前申请转正	我要转正
会议签到相关问题	会议签到相关问题
会议签到找谁	会议签到相关问题
有泛微在行业的排名和市场占有率的分析吗？	有泛微在行业的排名和市场占有率的分析吗？
契约锁合同签不了	契约锁合同签不了
我契约锁上的合同打不开	契约锁合同签不了
登录契约锁，里面没有我的劳动合同	契约锁合同签不了
契约锁上的电子合同不能签名	契约锁合同签不了
小e，这是怎么回事，契约锁合同签不了啊	契约锁合同签不了
你知道契约锁里的合同签不了是什么原因吗	契约锁合同签不了
为什么我的契约锁合同不能签啊	契约锁合同签不了
你给我看一下，我的契约锁上的所有合同都不能签是什么情况	契约锁合同签不了
我契约锁上有一份客户的合同，现在签不了了	契约锁合同签不了
企业号集成问题	企业号集成问题
企业号集成接入的时候提示java.net.unknowhostexception错误	企业号集成问题
电子合同与纸质合同有何区别？	电子合同与纸质合同有何区别？
费用报销的周期	费用报销的周期
这个月的报销费用什么时候能到账	费用报销的周期
出差报销一般几天到账	费用报销的周期
费用报销成功提交后多久能到账	费用报销的周期
费用报销正常要多久能下来	费用报销的周期
申请报销后，多久钱会到账	费用报销的周期
上次提交的钱什么时候给我	费用报销的周期
费用报销的反馈信息	费用报销的周期
报销后多久能拿到钱	费用报销的周期
多长时间报销一次	费用报销的周期
费用报销多久到账	费用报销的周期
费用报销流程提交最晚日期	费用报销的周期
发票截止日期	费用报销的周期
这个月报销流程的最晚提交期限是什么时候	费用报销的周期
公司每月报销的最终截至日期是什么时候	费用报销的周期
公司最晚可以什么时候报销	费用报销的周期
报销流程哪天截止	费用报销的周期
文档目录前端显示有问题如何解决	文档目录前端显示有问题如何解决
实施过程中的客户投诉怎么处理	实施过程中的客户投诉怎么处理
实施过程中的客户投诉找谁？	实施过程中的客户投诉怎么处理
项目实施时，客户反馈投诉找谁协助？	实施过程中的客户投诉怎么处理
实施中的客户投诉怎么处理	实施过程中的客户投诉怎么处理
移动端office知识管理附件在线编辑报错是什么原因	移动端office知识管理附件在线编辑报错是什么原因
云商店明细表，发起节点填写完后，提交会将明细表值清空是怎么回事？	云商店明细表，发起节点填写完后，提交会将明细表值清空是怎么回事？
企业实体印章如何实现智能管理？	企业实体印章如何实现智能管理？
如何智能管理企业实体印章	企业实体印章如何实现智能管理？
请问有没有产品演示方面的培训视频？	请问有没有产品演示方面的培训视频？
产品演示相关的培训资料？	请问有没有产品演示方面的培训视频？
我能看产品演示方面的培训资料？	请问有没有产品演示方面的培训视频？
产品演示的培训影片有吗	请问有没有产品演示方面的培训视频？
产品演示的资料我能看吗？	请问有没有产品演示方面的培训视频？
契约锁代理分成比例	契约锁代理分成比例
契约锁代理商如何分成？	契约锁代理分成比例
契约锁代理的分成比例是怎样的？	契约锁代理分成比例
契约锁代理商的分成比例是多少？	契约锁代理分成比例
契约锁代理商的分成比例向谁咨询？	契约锁代理分成比例
泛微网络开票信息	泛微网络开票信息
开票信息	泛微网络开票信息
公司税号	泛微网络开票信息
单位开票信息	泛微网络开票信息
单位网络的开票信息	泛微网络开票信息
单位网络开票信息	泛微网络开票信息
开票的抬头	泛微网络开票信息
泛微oa开票信息	泛微网络开票信息
泛微网络的开票信息	泛微网络开票信息
查一下公司税号	泛微网络开票信息
查找公司税号	泛微网络开票信息
发票抬头我要开哪个	泛微网络开票信息
公司的发票抬头要怎么写	泛微网络开票信息
我们公司的发票上面的抬头应该写什么啊	泛微网络开票信息
我在外面开发票人家问我发票抬头是什么	泛微网络开票信息
我和客户吃饭的发票抬头是写公司名字吗	泛微网络开票信息
公司的发票抬头可以在哪里查啊	泛微网络开票信息
我们公司的发票上面的抬头都是固定的吗	泛微网络开票信息
我们公司的发票抬头有几个啊	泛微网络开票信息
我下午出差回来开发票，发票抬头应该写什么	泛微网络开票信息
发票抬头的信息应该怎么填	泛微网络开票信息
想知道e-office的成功客户案例	想知道e-office的成功客户案例
e-office成功客户案例有吗？	想知道e-office的成功客户案例
e-office客户案例找谁要？	想知道e-office的成功客户案例
哪里有e-office成功客户案例？	想知道e-office的成功客户案例
e-office成功客户案例找谁咨询？	想知道e-office的成功客户案例
如何新建一个需要审批的协作？	如何新建一个需要审批的协作？
云商店菜单重复问题	云商店菜单重复问题
产品新功能研发进度咨询，该找谁处理	产品新功能研发进度咨询，该找谁处理
产品功能研发进度咨询谁？	产品新功能研发进度咨询，该找谁处理
产品新功能开发进度找谁咨询？	产品新功能研发进度咨询，该找谁处理
产品新功能开发的怎么样了？	产品新功能研发进度咨询，该找谁处理
产品新功能研发进度如何？	产品新功能研发进度咨询，该找谁处理
公积金怎么贷款	公积金怎么贷款
公积金贷款是怎么回事	公积金怎么贷款
小e，帮我查一下公积金贷款的操作步骤	公积金怎么贷款
我想知道用公积金贷款怎么贷	公积金怎么贷款
怎么申请公积金贷款	公积金怎么贷款
你知不知道怎样申请用公积金贷款，我要贷	公积金怎么贷款
请问怎么用公积金来贷款	公积金怎么贷款
我想申请一下用公积金来贷款	公积金怎么贷款
契约锁合同模版在哪里？	契约锁合同模版在哪里？
哪里找契约锁合同模板	契约锁合同模版在哪里？
谁有契约锁合同模板	契约锁合同模版在哪里？
契约锁合同模板找谁要	契约锁合同模版在哪里？
我想要契约锁合同模板找谁	契约锁合同模版在哪里？
哪里能下载契约锁合同模板	契约锁合同模版在哪里？
谁有契约锁合同的模板文件	契约锁合同模版在哪里？
契约锁合同模板在哪儿下载	契约锁合同模版在哪里？
数据源相关问题	数据源相关问题
数据源报错	数据源相关问题
谁负责数据源问题	数据源相关问题
数据源出错了找谁	数据源相关问题
矩阵管理是否支持管理分权和数据维护分权。	矩阵管理是否支持管理分权和数据维护分权。
oa流程归档后，流程表单、附件、正文，是否可以归档到中信档案系统、量子档案系统、紫光档案系统、中软档案系统？	oa流程归档后，流程表单、附件、正文，是否可以归档到中信档案系统、量子档案系统、紫光档案系统、中软档案系统？
e9在线应用开发编辑器如何接入？	e9在线应用开发编辑器如何接入？
苹果端没有推送了？	苹果端没有推送了？
苹果端是不是没推送了？	苹果端没有推送了？
苹果端推送没了？	苹果端没有推送了？
苹果端的推送在哪？	苹果端没有推送了？
推送在苹果上没了？	苹果端没有推送了？
苹果端的推送是不是没了？	苹果端没有推送了？
我们有ecology8.0的压测报告吗	我们有ecology8.0的压测报告吗
我们有ecology9.0的压测报告吗	我们有ecology8.0的压测报告吗
我们有emobile压测报告吗	我们有ecology8.0的压测报告吗
版本升级相关问题	版本升级相关问题
e9升级方案有哪些	版本升级相关问题
升级工作量是多少，怎么评估？	版本升级相关问题
升级后系统无法启动？	版本升级相关问题
升级后脚本不执行	版本升级相关问题
升级后有些自行开发丢了	版本升级相关问题
请问客户想做版本升级可以走什么流程？	版本升级相关问题
版本升级找谁？	版本升级相关问题
低版本升级e9走什么流程？	版本升级相关问题
客户要升级系统版本找谁？	版本升级相关问题
请问客户想做补丁升级可以走什么流程？	版本升级相关问题
请问客户想做kb补丁升级可以走什么流程？	版本升级相关问题
kb补丁升级问题找谁咨询？	版本升级相关问题
我想给客户升级找谁	版本升级相关问题
系统升级找谁	版本升级相关问题
正式系统更新找谁？	版本升级相关问题
提交的流程何时可以付款	提交的流程何时可以付款
个人付款怎么走流程	提交的流程何时可以付款
提交的流程多久可以付款	提交的流程何时可以付款
提交的流程什么时候可以付款	提交的流程何时可以付款
提交的流程怎样付款	提交的流程何时可以付款
个人付款走流程多级付款	提交的流程何时可以付款
个人付款多久可以走流程付款	提交的流程何时可以付款
项目管理相关问题	项目管理相关问题
你们的系统能够做工程项目管理吗?颗粒度能够管理到多细?	项目管理相关问题
在项目管理中,可以录入项目预算.但如何录入项目实际花费的金额呢?	项目管理相关问题
怎样显示项目任务的进度图表?	项目管理相关问题
我们的项目是科研类项目，需要在项目中期进行项目中期评审，你们是如何支撑的?	项目管理相关问题
你们的项目管理模块支持网络图和甘特图吗?	项目管理相关问题
我们的项目管理模块，项目状态是谁有权限修改的	项目管理相关问题
谁有权修改项目管理模块	项目管理相关问题
修改项目管理模块该找谁	项目管理相关问题
我们的项目分为项目组和项目管理组两层，如何实现项目信息向项目管理层推送?	项目管理相关问题
项目任务卡片字段任务负责人控制	项目管理相关问题
项目任务分解问题	项目管理相关问题
项目任务甘特图显示问题	项目管理相关问题
项目创建菜单为空白	项目管理相关问题
项目创建菜单怎么是空白的了	项目管理相关问题
项目创建出现空白该找谁解决	项目管理相关问题
谁是山东大区总经理	谁是山东大区总经理
如何快速学习产品新功能？	如何快速学习产品新功能？
e-teams技术层面和技术合作的问题，需要找谁来处理	e-teams技术层面和技术合作的问题，需要找谁来处理
e-teams技术合作找谁咨询？	e-teams技术层面和技术合作的问题，需要找谁来处理
e-teams技术层面相关问题找谁？	e-teams技术层面和技术合作的问题，需要找谁来处理
e-teams技术合作联系谁？	e-teams技术层面和技术合作的问题，需要找谁来处理
e-teams技术相关问题可以咨询谁？	e-teams技术层面和技术合作的问题，需要找谁来处理
e-teams技术合作找谁协助？	e-teams技术层面和技术合作的问题，需要找谁来处理
国产化电脑在线编辑正文需要哪些条件	国产化电脑在线编辑正文需要哪些条件
e8测试用例文件应该找谁要啊？	e8测试用例文件应该找谁要啊？
督办详情的值保存不上是为什么	督办详情的值保存不上是为什么
合同开2种税率发票，如何操作？	合同开2种税率发票，如何操作？
我要开2种不同的增值税发票	合同开2种税率发票，如何操作？
多种税率的发票如何开	合同开2种税率发票，如何操作？
多种税率的发票能否开	合同开2种税率发票，如何操作？
多种税率的发票怎么开	合同开2种税率发票，如何操作？
多种税率的发票要怎样开	合同开2种税率发票，如何操作？
客户需要开2种不同的增值税发票	合同开2种税率发票，如何操作？
开2种不同的增值税发票可以吗	合同开2种税率发票，如何操作？
logo设计找谁	logo设计找谁
变更协议模板	变更协议模板
变更协议有没有模板	变更协议模板
有没有变更协议模板	变更协议模板
变更协议模板在哪里下载	变更协议模板
怎么找到变更协议模板	变更协议模板
请帮我找一下变更协议的模板在哪	变更协议模板
我需要一份变更协议的模板	变更协议模板
给我一个模板，关于变更协议的	变更协议模板
人事问题	人事问题
人事相关问题	人事问题
人事	人事问题
开启分权后目录的维护权限怎么不生效了？	开启分权后目录的维护权限怎么不生效了？
分权开启后目录维护权限无法使用。	开启分权后目录的维护权限怎么不生效了？
开启分权后目录的维护权限咋不能用了？	开启分权后目录的维护权限怎么不生效了？
开启分权后目录的维护权限为啥失灵了？	开启分权后目录的维护权限怎么不生效了？
开启分权后目录的维护权限失灵了咋整的？	开启分权后目录的维护权限怎么不生效了？
我想查找泛微logo文件	我想查找泛微logo文件
公司logo文件如何提供？	我想查找泛微logo文件
单页打开的协作不能下拉查看内容怎么解决	单页打开的协作不能下拉查看内容怎么解决
我要寄快递	我要寄快递
下午2点可以寄快递吗	我要寄快递
寄快递在前台寄么？公司快件	我要寄快递
你好，请问这个光盘，可以在今天寄出吗？	我要寄快递
让前台下午之前把这份材料寄到社保局	我要寄快递
帮我寄个东西	我要寄快递
我想把这份资料寄给客户	我要寄快递
小林，给我把这个寄到宁波	我要寄快递
王总让我帮他寄一份客户资料	我要寄快递
寄给王子玉	我要寄快递
请问客户的需求是这样，有什么好的实现思路？有没有对应的方案？	请问客户的需求是这样，有什么好的实现思路？有没有对应的方案？
有好的方法和思路来对应客户的需求吗	请问客户的需求是这样，有什么好的实现思路？有没有对应的方案？
客户有新的需求，我们需要找队友的方案来实现	请问客户的需求是这样，有什么好的实现思路？有没有对应的方案？
大家有想法来满足这个客户的需求吗	请问客户的需求是这样，有什么好的实现思路？有没有对应的方案？
我们要针对客户提出了新的要求来制定方案	请问客户的需求是这样，有什么好的实现思路？有没有对应的方案？
谁有能满足这个客户需求的法子	请问客户的需求是这样，有什么好的实现思路？有没有对应的方案？
一般工作时间如何设置	一般工作时间如何设置
运维平台相关问题	运维平台相关问题
运维平台起不来了	运维平台相关问题
运维平台怎么停止	运维平台相关问题
运维平台访问不了	运维平台相关问题
运维平台是否可以提供接口	运维平台相关问题
您好，请问运维平台在哪里下载	运维平台相关问题
用户这边运维平台的admin密码忘记了怎么重置？	运维平台相关问题
请问下，运维平台端口怎么修改？	运维平台相关问题
大神，运维平台的服务怎么单独重启	运维平台相关问题
契约锁合同邮寄给谁	契约锁合同邮寄给谁
你知道契约锁合同邮寄给谁吗	契约锁合同邮寄给谁
我想咨询契约锁合同邮寄应该寄给谁	契约锁合同邮寄给谁
帮我查一下寄契约锁合同怎么寄	契约锁合同邮寄给谁
怎么寄契约锁合同	契约锁合同邮寄给谁
谁负责收寄送的契约锁合同	契约锁合同邮寄给谁
新客户的契约锁合同寄给谁	契约锁合同邮寄给谁
请告诉我契约锁合同邮寄给谁	契约锁合同邮寄给谁
如何修改人员卡片信息？	如何修改人员卡片信息？
人员卡片信息可以更改吗？	如何修改人员卡片信息？
我想修改我的卡片信息	如何修改人员卡片信息？
修改人员信息找谁？	如何修改人员卡片信息？
泛微能开16%的增值税发票吗？	泛微能开16%的增值税发票吗？
公司能不能开增值税发票	泛微能开16%的增值税发票吗？
泛微开票的增值税是多少	泛微能开16%的增值税发票吗？
泛微能开增值税发票吗	泛微能开16%的增值税发票吗？
咱么公司可以开增值税发票吗	泛微能开16%的增值税发票吗？
公司的开的增值税发票税率多少	泛微能开16%的增值税发票吗？
公司增值税发票交的税率？	泛微能开16%的增值税发票吗？
泛微开的是16%的增值税发票吗？	泛微能开16%的增值税发票吗？
公司能不能开16%税率的增值税发票？	泛微能开16%的增值税发票吗？
泛微能开6%的增值税发票吗？	泛微能开16%的增值税发票吗？
公司的开的增值税发票交的税率有多大	泛微能开16%的增值税发票吗？
咱么公司可以开6%的增值税发票吗	泛微能开16%的增值税发票吗？
谁是区域副总经理	谁是区域副总经理
找区域副总经理	谁是区域副总经理
找区域副总	谁是区域副总经理
我要打篮球	我要打篮球
今天晚上有人报名参加公司的篮球比赛吗	我要打篮球
公司的篮球比赛是什么时候啊	我要打篮球
公司每周都有篮球比赛吗	我要打篮球
公司有篮球俱乐部吗	我要打篮球
公司给员工安排的篮球场地在什么地方啊	我要打篮球
我想加入篮球俱乐部	我要打篮球
我想加入篮球qq群	我要打篮球
你可以帮我预定一下今天晚上的篮球比赛的名额吗	我要打篮球
我想看看公司最近篮球的比赛项目是什么	我要打篮球
今天晚上帮我组织几个人一起打个篮球	我要打篮球
我要领生日礼物	我要领生日礼物
我的生日礼物怎么领取啊	我要领生日礼物
今年我的生日公司有哪些礼物送啊	我要领生日礼物
公司关于员工的生日有什么活动安排吗	我要领生日礼物
公司对员工的生日有什么福利吗	我要领生日礼物
我下周就过生日了，公司可以提供什么福利吗	我要领生日礼物
我想查一查公司对员工的生日礼物有哪些	我要领生日礼物
我现在可以领我的生日礼物吗	我要领生日礼物
服务器配置推荐	服务器配置推荐
现在有e9的服务器配置推荐吗	服务器配置推荐
服务器硬件配置推荐	服务器配置推荐
硬件配置推荐	服务器配置推荐
老客户合同变更怎么处理？	老客户合同变更怎么处理？
老客户的合同可以修改协议吗？	老客户合同变更怎么处理？
老客户的合同变更相关问题要联系谁呢？	老客户合同变更怎么处理？
老客户的合同修改变更需要走什么流程呢？	老客户合同变更怎么处理？
老客户的合同协议可以变更吗？	老客户合同变更怎么处理？
老客户合同需要修改找谁？	老客户合同变更怎么处理？
老客户合同变更的协议的模板找不到？	老客户合同变更怎么处理？
老客户合同可以变更哪些协议？	老客户合同变更怎么处理？
要采购第三方产品，如何处理	要采购第三方产品，如何处理
采购第三方产品相关问题找谁？	要采购第三方产品，如何处理
如何购买第三方产品	要采购第三方产品，如何处理
购第三方产品的流程	要采购第三方产品，如何处理
购第三方产品要注意哪些	要采购第三方产品，如何处理
我需要购第三方产品，找谁咨询啊	要采购第三方产品，如何处理
请问买第三方产品的步骤	要采购第三方产品，如何处理
购第三方产品我不熟悉，找谁啊	要采购第三方产品，如何处理
it事项确认单流程，添加附件，流程提交之后，附件就看不到了，流程创建完保存附件还在，这个问题找谁	it事项确认单流程，添加附件，流程提交之后，附件就看不到了，流程创建完保存附件还在，这个问题找谁
谁是浙闽大区总经理	谁是浙闽大区总经理
webservice调用	webservice调用
webservice怎么调用	webservice调用
em6相关问题	em6相关问题
请问em6手机客户端登录不上怎么处理？	em6相关问题
emobile6手机客户端无法登录怎么处理？	em6相关问题
emobile6手机客户端登录失败要怎么办？	em6相关问题
em6手机客户端登录失败怎么办？	em6相关问题
请问em6手机服务端更新包去哪里找？	em6相关问题
em6手机服务端去哪里弄？	em6相关问题
em6手机服务端更新包去哪里要？	em6相关问题
emobile6手服务端更新包怎么可以得到？	em6相关问题
em6手机服务端更新包要怎么申请？	em6相关问题
em6手机客户端无法登录怎么处理？	em6相关问题
em6手机客户端无法登录不上怎么处理？	em6相关问题
请问em6手机客户端登录不上咋整？	em6相关问题
em6手机客户端登录失败要怎么办？	em6相关问题
emobile6手机客户端登录失败怎么办？	em6相关问题
em6手机客户端登录不上要我怎么搞？	em6相关问题
为什么em6手机端无法收到消息弹出提醒	em6相关问题
em6移动端上上传附件报错接口错误代码 413，是什么问题	em6相关问题
em6移动端浏览框数据显示不全是为何	em6相关问题
移动端配置完成之后，e-mobile下载显示6.0正常吗	em6相关问题
em6移动端待办点击后消息中心处理状态变为“已处理”,点进去无法提交，到代办里面打开又可以提交是怎么回事	em6相关问题
em6移动端问题咨询	em6相关问题
emobile6移动端打开消息显示未连接，重新配置部署后消息依旧显示未连接	em6相关问题
em6苹果移动端 通讯录里面部门无法显示人员？	em6相关问题
em6移动端人员头像不显示是为何	em6相关问题
e9 pc端的js，可以直接用到em6移动端上吗？	em6相关问题
emobile6移动端邮件查看wps，doc、docx文件无法预览打开，并报错是什么原因？	em6相关问题
em6移动端查看图片弹出需要第三方应用，这个怎么解决啊？	em6相关问题
请问em6手机消息连不上怎么搞？	em6相关问题
请问em6手机消息无法连接怎么解决？ em6手机消息无法连接怎么处理？	em6相关问题
em6手机消息无法连接怎么处理？	em6相关问题
请问em6手机消息连不上怎么处理？	em6相关问题
请问em6手机消息没发连接要怎么弄？	em6相关问题
我想重发工资条	我想重发工资条
可以重发工资条吗	我想重发工资条
工资条可以重发下吗	我想重发工资条
给我一张新的工资条吧	我想重发工资条
再发我一张工资条吧	我想重发工资条
能重发一张工资条给我吗	我想重发工资条
再给我一张工资条吧	我想重发工资条
再领一张工资条	我想重发工资条
android定位相关问题？	android定位相关问题？
android定位有关问题？	android定位相关问题？
和android定位相关问题？	android定位相关问题？
有没有android定位上问题？	android定位相关问题？
有android定位问题？	android定位相关问题？
做了哪些政务客户	做了哪些政务客户
小e相关问题	小e相关问题
小e怎么申请	小e相关问题
小e需要打补丁包吗	小e相关问题
小e支持哪些功能	小e相关问题
阿里云架构问题和配置问题	阿里云架构问题和配置问题
关于阿里云架构的问题	阿里云架构问题和配置问题
阿里云架构怎么弄	阿里云架构问题和配置问题
阿里云架构谁负责	阿里云架构问题和配置问题
阿里云架构找谁	阿里云架构问题和配置问题
阿里云架构方面问题要找谁	阿里云架构问题和配置问题
阿里云系统出错了怎么办	阿里云架构问题和配置问题
阿里云系统出错了该找谁解决	阿里云架构问题和配置问题
阿里云架构方案	阿里云架构问题和配置问题
阿里云架构计划	阿里云架构问题和配置问题
阿里云架构设计方案	阿里云架构问题和配置问题
阿里云架构解决方案	阿里云架构问题和配置问题
阿里云怎么架构	阿里云架构问题和配置问题
哪里找阿里云架构方案	阿里云架构问题和配置问题
阿里云架构设计方案在哪里	阿里云架构问题和配置问题
我想要阿里云架构方案	阿里云架构问题和配置问题
阿里云管理模式	阿里云架构问题和配置问题
阿里云系统配置	阿里云架构问题和配置问题
阿里云配置清单	阿里云架构问题和配置问题
阿里云配置详细信息	阿里云架构问题和配置问题
阿里云配置目录	阿里云架构问题和配置问题
阿里云配置指南	阿里云架构问题和配置问题
阿里云配置参考资料	阿里云架构问题和配置问题
阿里云配置详细信息找谁咨询	阿里云架构问题和配置问题
哪里能找到阿里云配置参考资料	阿里云架构问题和配置问题
e9如何与第三方app集成	e9如何与第三方app集成
人事基础信息表的表结构咨询	人事基础信息表的表结构咨询
邮件模块数据是不是会定期清理？	邮件模块数据是不是会定期清理？
云桥如何配置流程	云桥如何配置流程
云桥怎么配置流程	云桥如何配置流程
云桥要怎么配置流程	云桥如何配置流程
云桥配置流程怎么搞	云桥如何配置流程
云桥配置流程要怎么整	云桥如何配置流程
派车要找谁	派车要找谁
发票丢了怎么办？	发票丢了怎么办？
发票丢了还能补开吗	发票丢了怎么办？
可以补开发票吗	发票丢了怎么办？
开的发票丢失了，还可以补开吗	发票丢了怎么办？
发票丢了是否能补开	发票丢了怎么办？
发票丢了还能再开一张吗	发票丢了怎么办？
发票丢了如何处理	发票丢了怎么办？
发票丢了如何解决	发票丢了怎么办？
android推送相关的问题？	android推送相关的问题？
android推送有关的问题？	android推送相关的问题？
有没有android推送相关的问题？	android推送相关的问题？
和android推送相关的问题？	android推送相关的问题？
安卓推送上的问题	android推送相关的问题？
我想要组织架构图	我想要组织架构图
我想看组织架构图	我想要组织架构图
发我一下组织架构图	我想要组织架构图
让我看下组织架构图	我想要组织架构图
可以看下组织架构图吗	我想要组织架构图
组织架构图在哪里查看	我想要组织架构图
如何查看要组织架构图	我想要组织架构图
公司的组织架构图发我下	我想要组织架构图
新客户合同变更怎么处理？	新客户合同变更怎么处理？
新客户的合同可以修改协议吗？	新客户合同变更怎么处理？
新客户的合同变更相关问题要联系谁呢？	新客户合同变更怎么处理？
新客户的合同修改变更需要走什么流程呢？	新客户合同变更怎么处理？
新客户的合同协议可以变更吗？	新客户合同变更怎么处理？
新客户合同需要修改找谁？	新客户合同变更怎么处理？
新客户合同变更的协议的模板找不到？	新客户合同变更怎么处理？
新客户合同可以变更哪些协议？	新客户合同变更怎么处理？
有没有建模的操作手册	有没有建模的操作手册
建模的操作手册谁有	有没有建模的操作手册
想要非投标合同扫描件	想要非投标合同扫描件
这个非投标合同帮我扫描一下	想要非投标合同扫描件
我想要这个非投标合同的扫描件去找谁	想要非投标合同扫描件
非投标合同扫描的相关问题要联系谁	想要非投标合同扫描件
我的非投标合同帮我扫描了吗	想要非投标合同扫描件
这个非投标合同能扫描吗	想要非投标合同扫描件
今天可以扫描非投标合同吗	想要非投标合同扫描件
把非投标合同扫描件发给我	想要非投标合同扫描件
谁是ebu客服总监	谁是ebu客服总监
手机端通讯或者选择人员组织结构浏览按钮是否支持应用分权	手机端通讯或者选择人员组织结构浏览按钮是否支持应用分权
人员搜索支持姓名全拼搜索需求有说明吗	人员搜索支持姓名全拼搜索需求有说明吗
人员搜索支持姓名全拼搜索实现了吗	人员搜索支持姓名全拼搜索需求有说明吗
结束状态的协作还可以发表协作交流吗？	结束状态的协作还可以发表协作交流吗？
结束状态的协作还可以再次打开吗？	结束状态的协作还可以发表协作交流吗？
协作显示“结束”的状态，还能被再次打开吗	结束状态的协作还可以发表协作交流吗？
正式系统的需要做出调整应该找谁处理？	正式系统的需要做出调整应该找谁处理？
调整系统环境要找谁	正式系统的需要做出调整应该找谁处理？
老客户合同能和发票一起寄出吗	老客户合同能和发票一起寄出吗
老客户的合同能和发票一起寄出吗	老客户合同能和发票一起寄出吗
老客户的发票一起邮寄了吗	老客户合同能和发票一起寄出吗
老客户合同的合同和发票什么时候能一起寄出啊	老客户合同能和发票一起寄出吗
有位老客户需要发票，可以和合同一并寄出吗	老客户合同能和发票一起寄出吗
给老客户发票邮寄的相关问题联系谁	老客户合同能和发票一起寄出吗
给老客户的发票可以单独邮寄吗	老客户合同能和发票一起寄出吗
老客户的发票是由谁邮寄的	老客户合同能和发票一起寄出吗
手机端文档应用加载慢如何处理	手机端文档应用加载慢如何处理
结算款相关问题该找谁	结算款相关问题该找谁
为什么机构结算款金额和付款金额不一致？	结算款相关问题该找谁
什么是机构结算款？	结算款相关问题该找谁
我想查一下机构结算款的计算规则	结算款相关问题该找谁
请问机构结算款是按什么规则进行计算的？	结算款相关问题该找谁
机构结算款和付款金额为什么会不一样？	结算款相关问题该找谁
什么原因会导致机构结算款和付款金额不一致？	结算款相关问题该找谁
我不知道剩余结算款金额是否正确？	结算款相关问题该找谁
剩余结算款应该怎么计算	结算款相关问题该找谁
剩余结算款是怎么核算的？	结算款相关问题该找谁
剩余结算款核算找谁？	结算款相关问题该找谁
剩余结算款的计算规则是怎样的？	结算款相关问题该找谁
剩余结算款是按什么方式计算出来的？	结算款相关问题该找谁
剩余结算款有错误？	结算款相关问题该找谁
我的剩余结算款是怎么算出来的？	结算款相关问题该找谁
新客户寄来需办理的合同收到了吗？	新客户寄来需办理的合同收到了吗？
新客户寄来的需办理的合同收到了吗？	新客户寄来需办理的合同收到了吗？
新客户的需办理的合同寄过来了吗？	新客户寄来需办理的合同收到了吗？
新客户需办理的合同盖章了吗？	新客户寄来需办理的合同收到了吗？
新客户的需办理合同怎么还没到？	新客户寄来需办理的合同收到了吗？
帮我找一个新客户寄来的需办理合同	新客户寄来需办理的合同收到了吗？
有位新客户需办理的合同帮我盖章邮寄一下	新客户寄来需办理的合同收到了吗？
新客户的需办理的合同盖章要找谁？	新客户寄来需办理的合同收到了吗？
oa上了非标准功能【统一认证中心】，第3方系统是否需要开发，能否提供开发资料？	oa上了非标准功能【统一认证中心】，第3方系统是否需要开发，能否提供开发资料？
我要开在职证明	我要开在职证明
我准备办理护照，需要开一个在职证明	我要开在职证明
在职证明需要办理什么手续吗	我要开在职证明
我来公司实习三个月了可以开在职证明吗	我要开在职证明
我上周刚来公司上班可以给我开一个在职证明吗	我要开在职证明
在职证明需要我本人签字吗	我要开在职证明
我明天要去银行办理贷款需要开一个在职证明	我要开在职证明
公司在职证明怎么开啊	我要开在职证明
ecology8系统意见为必填时点击提交按钮页面不自动滚动至意见区是什么原因	ecology8系统意见为必填时点击提交按钮页面不自动滚动至意见区是什么原因
e-office集成外部数据库支持的类型有哪些?	e-office集成外部数据库支持的类型有哪些?
e-office集成外部数据库支持的啥?	e-office集成外部数据库支持的类型有哪些?
e-office集成外部数据库可以用什么类型?	e-office集成外部数据库支持的类型有哪些?
督办任务提醒怎么设置	督办任务提醒怎么设置
产品配置找谁	产品配置找谁
我要找产品配置	产品配置找谁
微博问题找谁	微博问题找谁
微博相关问题	微博问题找谁
微博有问题咨询谁	微博问题找谁
谁负责解决微博相关问题	微博问题找谁
日程共享为什么无效?	日程共享为什么无效?
日程共享用不了	日程共享为什么无效?
日程共享没法用	日程共享为什么无效?
日程共享失效	日程共享为什么无效?
e-ffice10.0 如何快捷的迁移系统？	e-ffice10.0 如何快捷的迁移系统？
e-ffice10.0 上面怎么最快的迁移系统？	e-ffice10.0 如何快捷的迁移系统？
e-ffice10.0 数据迁移怎么弄最快？	e-ffice10.0 如何快捷的迁移系统？
e-office的二次开发找谁来处理	e-office的二次开发找谁来处理
e-office二次开发找谁协助？	e-office的二次开发找谁来处理
e-office二次开发相关问题咨询谁？	e-office的二次开发找谁来处理
e-office二次开发问谁？	e-office的二次开发找谁来处理
e-office二开应该找谁咨询？	e-office的二次开发找谁来处理
数据库初始化出现错误	数据库初始化出现错误
后台报数据库连接错误，帮我看一下	数据库初始化出现错误
数据库初始化失败怎么办	数据库初始化出现错误
查询合同找谁	查询合同找谁
正文的模板，选择框模板无法保存	正文的模板，选择框模板无法保存
没法保存正文模板中的选择框模板	正文的模板，选择框模板无法保存
移动建模产品咨询，配置，需求相关问题？	移动建模产品咨询，配置，需求相关问题？
怎么操作移动建模工具？	移动建模产品咨询，配置，需求相关问题？
移动建模项目实施中问题可以咨询谁？	移动建模产品咨询，配置，需求相关问题？
表单建模和移动建模产品如何提交项目bug、需求开发申请？	移动建模产品咨询，配置，需求相关问题？
移动建模的相关数据和功能哪里来呢？	移动建模产品咨询，配置，需求相关问题？
你们移动建模和业务建模是什么关系？	移动建模产品咨询，配置，需求相关问题？
是不是有了移动建模我就可以随意发布功能到手机上？	移动建模产品咨询，配置，需求相关问题？
如何在移动建模中添加样式代码？	移动建模产品咨询，配置，需求相关问题？
移动建模现成的应用案例哪里去找	移动建模产品咨询，配置，需求相关问题？
移动建模中如何扫描二维码	移动建模产品咨询，配置，需求相关问题？
移动建模二次开发需求是否可以实现	移动建模产品咨询，配置，需求相关问题？
外部用户如何通过扫码访问移动建模的页面	移动建模产品咨询，配置，需求相关问题？
移动建模中sql执行不了如何处理	移动建模产品咨询，配置，需求相关问题？
移动建模lbs控件无法获得当前地址是为何	移动建模产品咨询，配置，需求相关问题？
移动建模和业务建模是什么关系	移动建模产品咨询，配置，需求相关问题？
能否简单说明一下我们怎么操作移动建模工具？	移动建模产品咨询，配置，需求相关问题？
移动建模图表控件sql能否传参数？	移动建模产品咨询，配置，需求相关问题？
是不是有了移动建模就可以随意发布功能到手机上？	移动建模产品咨询，配置，需求相关问题？
移动建模的应用如何发布到手机端emobile	移动建模产品咨询，配置，需求相关问题？
移动建模文档在手机上点击没反应，无法打开是怎么回事？	移动建模产品咨询，配置，需求相关问题？
采编高级搜索时间范围字段标签名不对是什么问题	采编高级搜索时间范围字段标签名不对是什么问题
政务解决方案	政务解决方案
e9的ldap集成如何配置	e9的ldap集成如何配置
ldap集成相关问题找谁咨询？	e9的ldap集成如何配置
ldap集成如何配置？	e9的ldap集成如何配置
ldap集成配置问题联系谁？	e9的ldap集成如何配置
我想了解e9的ldap集成怎么配置？	e9的ldap集成如何配置
代理商购买产品需要我们实施，走什么流程	代理商购买产品需要我们实施，走什么流程
代理商需要实施支持找谁？	代理商购买产品需要我们实施，走什么流程
代理商需要实施协助走什么流程？	代理商购买产品需要我们实施，走什么流程
协助代理商实施找谁咨询？	代理商购买产品需要我们实施，走什么流程
代理商需要我们实施怎么解决？	代理商购买产品需要我们实施，走什么流程
客户明细表增强插件配置好后，流程打开报错怎么解决	客户明细表增强插件配置好后，流程打开报错怎么解决
契约锁	契约锁
没有收到相关功能的包	没有收到相关功能的包
客户的这个功能已经过了交付日期了，我还没有收到包？	没有收到相关功能的包
没有及时收到流程相关功能包？	没有收到相关功能的包
没有及收到客户需要的功能的相关的包找谁？	没有收到相关功能的包
交付功能没有收到相关功能包？	没有收到相关功能的包
没有收到测试功能包吗？	没有收到相关功能的包
测试人没有收到相关功能包找谁？	没有收到相关功能的包
流程测试人收到相关功能包了吗？	没有收到相关功能的包
查看上海管理合同模块的负责人	查看上海管理合同模块的负责人
项目调研过程中应该注意的事项？	项目调研过程中应该注意的事项？
抄送有没有办法使用批量提交	抄送有没有办法使用批量提交
目前系统支持的浏览器版本	目前系统支持的浏览器版本
系统支持ie浏览器吗	目前系统支持的浏览器版本
系统支持chrome浏览器吗	目前系统支持的浏览器版本
系统支持edge浏览器吗	目前系统支持的浏览器版本
我们的ecology支持谷歌浏览器吗	目前系统支持的浏览器版本
能使用火狐浏览器打开系统吗	目前系统支持的浏览器版本
明细行币别浏览框对不齐，有类似的问题解决方案吗	明细行币别浏览框对不齐，有类似的问题解决方案吗
契约锁与商旅平台集成的相关问题	契约锁与商旅平台集成的相关问题
契约锁与滴滴集成是否有标准包	契约锁与商旅平台集成的相关问题
契约锁集成了哪些商旅平台	契约锁与商旅平台集成的相关问题
项目管理产品咨询，配置，需求相关问题？	项目管理产品咨询，配置，需求相关问题？
项目管理产品相关问题找谁？	项目管理产品咨询，配置，需求相关问题？
项目管理产品配置问题找谁？	项目管理产品咨询，配置，需求相关问题？
项目管理产品需求相关问题找谁？	项目管理产品咨询，配置，需求相关问题？
请问h5宣传页面，应该找谁，走什么流程	请问h5宣传页面，应该找谁，走什么流程
h5宣传页面设计找谁咨询？	请问h5宣传页面，应该找谁，走什么流程
可以签框架协议模版吗？	可以签框架协议模版吗？
能签框架协议模版吗？	可以签框架协议模版吗？
请问我自己可以签框架协议模版吗？	可以签框架协议模版吗？
框架协议模版，我自己能决定签吗？	可以签框架协议模版吗？
我需要签署框架协议模版的注意事项	可以签框架协议模版吗？
怎么签框架协议模版啊	可以签框架协议模版吗？
我需要签和客户签框架协议模版	可以签框架协议模版吗？
我有权利签框架协议模版吗	可以签框架协议模版吗？
要设计一个图标找谁	要设计一个图标找谁
各版本产品功能之间有什么差别？	各版本产品功能之间有什么差别？
我要查询绩效分值	我要查询绩效分值
看下我的绩效分	我要查询绩效分值
怎么看绩效分值	我要查询绩效分值
哪里看绩效分值	我要查询绩效分值
绩效分值在哪看	我要查询绩效分值
我这个月的绩效分值是多少	我要查询绩效分值
本月给我打了多少绩效分值	我要查询绩效分值
我的绩效分值高吗	我要查询绩效分值
薪资模块数据是否支持数据库加密存储功能。	薪资模块数据是否支持数据库加密存储功能。
客户化开发需求可行性咨询和讨论评估、客户开发现场调试支持、客户售前技术支持、客户需求开发进度咨询，该找谁处理	客户化开发需求可行性咨询和讨论评估、客户开发现场调试支持、客户售前技术支持、客户需求开发进度咨询，该找谁处理
客户化开发需求可行性找谁咨询？	客户化开发需求可行性咨询和讨论评估、客户开发现场调试支持、客户售前技术支持、客户需求开发进度咨询，该找谁处理
客户开发现场调试支持咨询谁？	客户化开发需求可行性咨询和讨论评估、客户开发现场调试支持、客户售前技术支持、客户需求开发进度咨询，该找谁处理
客户售前技术支持咨询谁？	客户化开发需求可行性咨询和讨论评估、客户开发现场调试支持、客户售前技术支持、客户需求开发进度咨询，该找谁处理
客户需求开发进度联系谁？	客户化开发需求可行性咨询和讨论评估、客户开发现场调试支持、客户售前技术支持、客户需求开发进度咨询，该找谁处理
云商店插件设置不完整显示问题	云商店插件设置不完整显示问题
新客户的合同办理了吗/寄出去了吗？	新客户的合同办理了吗/寄出去了吗？
新客户的合同办好了吗？是否寄出？	新客户的合同办理了吗/寄出去了吗？
新客户合同办好邮寄了吗	新客户的合同办理了吗/寄出去了吗？
新客户的合同什么时候办理	新客户的合同办理了吗/寄出去了吗？
新客户的合同什么时候能邮寄出去	新客户的合同办理了吗/寄出去了吗？
给新客户的合同谁负责邮寄出去	新客户的合同办理了吗/寄出去了吗？
给新客户邮寄合同要找谁	新客户的合同办理了吗/寄出去了吗？
这个新客户的合同请尽快帮我办理邮寄出去	新客户的合同办理了吗/寄出去了吗？
配置部负责人是谁	配置部负责人是谁
谁是配置部的负责人	配置部负责人是谁
我找配置部负责人	配置部负责人是谁
预算里面的控制节点啥意思	预算里面的控制节点啥意思
新客户合同能和发票一起寄出吗	新客户合同能和发票一起寄出吗
新客户的合同能和发票一起寄出吗	新客户合同能和发票一起寄出吗
新客户的发票一起邮寄了吗	新客户合同能和发票一起寄出吗
新客户合同的合同和发票什么时候能一起寄出啊	新客户合同能和发票一起寄出吗
有位新客户需要发票，可以和合同一并寄出吗	新客户合同能和发票一起寄出吗
给新客户发票邮寄的相关问题联系谁	新客户合同能和发票一起寄出吗
给新客户的发票可以单独邮寄吗	新客户合同能和发票一起寄出吗
新客户的发票是由谁邮寄的	新客户合同能和发票一起寄出吗
总部、上海大区人事行政制度的问题?	总部、上海大区人事行政制度的问题?
总部的人事制度找谁？	总部、上海大区人事行政制度的问题?
总部的行政制度咨询？	总部、上海大区人事行政制度的问题?
上海大区的人事行政制度找谁？	总部、上海大区人事行政制度的问题?
如何根据文档id获取文档真实存放路径脚本	如何根据文档id获取文档真实存放路径脚本
审计报告在哪查询	审计报告在哪查询
看下审计报告	审计报告在哪查询
怎么看审计报告	审计报告在哪查询
哪里可以看到审计报告	审计报告在哪查询
找谁要审计报告	审计报告在哪查询
如何查询审计报告	审计报告在哪查询
审计报告怎么查	审计报告在哪查询
我要查询审计报告	审计报告在哪查询
公司支持哪些类型的票据方式	公司支持哪些类型的票据方式
财务部门是怎么收取承兑汇票	公司支持哪些类型的票据方式
承兑汇票形式支持吗	公司支持哪些类型的票据方式
客户付款的是时候可以用承兑汇票吗	公司支持哪些类型的票据方式
公司接受银行汇票吗	公司支持哪些类型的票据方式
目前有哪些类型的票据方式	公司支持哪些类型的票据方式
公司接受银行承兑汇票吗	公司支持哪些类型的票据方式
公司是否接受银行汇票	公司支持哪些类型的票据方式
承兑汇票形式公司接受吗	公司支持哪些类型的票据方式
公司支持支付宝转账付款吗	公司支持哪些类型的票据方式
公司是否收取承兑汇票	公司支持哪些类型的票据方式
公司是否收取支票	公司支持哪些类型的票据方式
公司收取支票的时候会有手续费吗	公司支持哪些类型的票据方式
公司收支票吗	公司支持哪些类型的票据方式
客户要用发票支付,可以吗	公司支持哪些类型的票据方式
客户的支票咱么公司能兑现吗	公司支持哪些类型的票据方式
找一下保安	找一下保安
叫保安	找一下保安
新员工产品考试知识地图在哪里找	新员工产品考试知识地图在哪里找
流程模块	流程模块
统一待办相关问题找谁	流程模块
流程模板	流程模块
流程智能导入	流程模块
excel导入流程找谁	流程模块
短信相关问题	短信相关问题
短信问题找谁	短信相关问题
异构系统表单相关问题	异构系统表单相关问题
异构系统的表单可不可以作为列表和浏览按钮在oa里显示出来	异构系统表单相关问题
异构系统的表单可不可以在oa里显示成列表和浏览按钮	异构系统表单相关问题
相关交流-高级搜索-起止日期查询问题找谁	相关交流-高级搜索-起止日期查询问题找谁
请问新客户如何备案？	请问新客户如何备案？
新客户备案找谁咨询？	请问新客户如何备案？
自定义部门矩阵问题找谁	自定义部门矩阵问题找谁
矩阵管理系统默认分部、部门矩阵是如何生成的。	矩阵管理系统默认分部、部门矩阵是如何生成的。
想了解渠道合作政策的伙伴	想了解渠道合作政策的伙伴
如何做流程触发集成	如何做流程触发集成
怎么做流程触发集成	如何做流程触发集成
流程触发集成要怎么搞	如何做流程触发集成
iwebpdf	iwebpdf
契约锁投标找谁	契约锁投标找谁
契约锁投标找谁负责	契约锁投标找谁
谁负责契约锁投标	契约锁投标找谁
你知道契约锁投标找谁吗	契约锁投标找谁
我想咨询契约锁投标应该找谁	契约锁投标找谁
帮我查一下契约锁投标怎么投	契约锁投标找谁
请问谁负责契约锁投标	契约锁投标找谁
契约锁投标相关问题应该找谁	契约锁投标找谁
谁知道怎么做契约锁投标	契约锁投标找谁
我要体检	我要体检
我的体检是安排在哪一天	我要体检
我昨天刚入职的，什么时候可以体检	我要体检
我准备下个月离职，公司的体检我还可以报名吗	我要体检
怎么报名今年的员工体检啊	我要体检
我上半年的体检还没体检呢	我要体检
我上半年的体检报告什么时候可以拿的到啊	我要体检
我可以替我的同事一起报名下个月的公司年度体检吗	我要体检
我要开介绍信	我要开介绍信
介绍信应该怎么写	我要开介绍信
写介绍信要准备哪些材料啊	我要开介绍信
介绍信可以每个人都写吗	我要开介绍信
我明天准备离职了，但是公司这边还可以给我写一个介绍信吗	我要开介绍信
公司的介绍信的格式是什么样的	我要开介绍信
公司这边同意为新员工写介绍信吗	我要开介绍信
我已经辞职了还可以麻烦公司给我写个介绍信吗	我要开介绍信
e-teams产品开发意见和产品需求咨询	e-teams产品开发意见和产品需求咨询
e-teams产品需求相关问题找谁咨询？	e-teams产品开发意见和产品需求咨询
e-teams产品开发找谁？	e-teams产品开发意见和产品需求咨询
e-teams开发意见咨询谁？	e-teams产品开发意见和产品需求咨询
e-teams开发需求找谁？	e-teams产品开发意见和产品需求咨询
没有商机找谁	没有商机找谁
要投标人员资质证书	要投标人员资质证书
给我投标人员资质证书	要投标人员资质证书
投标人员资质证书发我下	要投标人员资质证书
投标人员资质证书有的话给我	要投标人员资质证书
我要一份投标人员资质证书	要投标人员资质证书
请把投标人员资质证书给我	要投标人员资质证书
你这边有投标人员资质证书吗，有的话给我一份	要投标人员资质证书
可以给我一份投标人员资质证书吗	要投标人员资质证书
em7如何购买如何报价	em7如何购买如何报价
em7如何购买如何报价的相关问题该咨询谁	em7如何购买如何报价
我想了解下em7如何购买	em7如何购买如何报价
我想了解下em7如何报价	em7如何购买如何报价
科目为什么在流程中选不到	科目为什么在流程中选不到
如何排查金格插件的兼容性问题	如何排查金格插件的兼容性问题
ca机构颁发的数字证书是什么？	ca机构颁发的数字证书是什么？
什么是ca	ca机构颁发的数字证书是什么？
我想了解一下ca	ca机构颁发的数字证书是什么？
数字证书有什么用？	ca机构颁发的数字证书是什么？
咱们系统有没有访问日志	咱们系统有没有访问日志
系统有访问日志吗？	咱们系统有没有访问日志
系统访问日志在哪里查看？	咱们系统有没有访问日志
我们的系统有访问记录吗？	咱们系统有没有访问日志
怎么查询系统的访问日志？	咱们系统有没有访问日志
表单建模产品咨询，配置，需求相关问题？	表单建模产品咨询，配置，需求相关问题？
建模表单中的“数据提醒”是啥意思？	表单建模产品咨询，配置，需求相关问题？
表单建模里边划分权限怎么设置？	表单建模产品咨询，配置，需求相关问题？
表单建模模块通用扩展配置？	表单建模产品咨询，配置，需求相关问题？
表单建模权限改造方案？	表单建模产品咨询，配置，需求相关问题？
表单建模需求设计？	表单建模产品咨询，配置，需求相关问题？
我所在团队分享过多少个场景？	我所在团队分享过多少个场景？
发票查询	发票查询
看一下我的发票	发票查询
看一下我的报销流程	发票查询
报销流程查看	发票查询
我想看看我提交的报销发票	发票查询
我发票提交了没	发票查询
查一下发票	发票查询
我可以查询一下我开的发票吗	发票查询
给我查询一下发票	发票查询
查询我的报销发票	发票查询
谁是苏皖大区总经理	谁是苏皖大区总经理
如何获取契约锁升级包	如何获取契约锁升级包
我想获取契约锁升级包要怎么做	如何获取契约锁升级包
谁能搞定契约锁升级包的问题	如何获取契约锁升级包
流程超时相关问题	流程超时相关问题
流程超时没有发送微信消息提醒	流程超时相关问题
流程超时触发的条件有哪些	流程超时相关问题
流程设置了超时自动提交但没有生效可能是什么问题	流程超时相关问题
流程超时提醒提醒方式信息中心，这个提醒方式手机能收到提醒吗	流程超时相关问题
流程超时是否有效怎么检查	流程超时相关问题
部门要聚餐	部门要聚餐
我们部门今晚准备聚餐	部门要聚餐
部门每个月都可以聚餐吗	部门要聚餐
我今年组织一下部门的公司聚餐	部门要聚餐
部门聚餐有什么限制吗	部门要聚餐
部门聚餐可以吃西餐吗	部门要聚餐
部门聚餐有没有人数限制啊	部门要聚餐
公司部门聚餐一般都去什么地方啊	部门要聚餐
我们聚餐都有哪些地方可以选择啊	部门要聚餐
公司多久可以聚餐一次啊	部门要聚餐
权限中心管理分权和组织结构应用分权如何设置，此两个分权有什么区别	权限中心管理分权和组织结构应用分权如何设置，此两个分权有什么区别
客户验收了吗？验收时间？	客户验收了吗？验收时间？
我们产品客户什么时候验收的	客户验收了吗？验收时间？
这个功能客户收货了吗	客户验收了吗？验收时间？
这个产品什么时候给的客户	客户验收了吗？验收时间？
每次打开后端左边都要加载很久是什么问题？	每次打开后端左边都要加载很久是什么问题？
陪产假多少天怎么请	陪产假多少天怎么请
我想知道如何请陪产假	陪产假多少天怎么请
我要请陪产假，怎么走流程	陪产假多少天怎么请
我们公司关于陪产假的制度是怎样的，怎么请	陪产假多少天怎么请
陪产假大概有多少天	陪产假多少天怎么请
我孩子下周要出生了，怎么休陪产假	陪产假多少天怎么请
我想申请下周开始休陪产假，应该怎么做	陪产假多少天怎么请
我可以请几天陪产假	陪产假多少天怎么请
国产化支持哪些数据库	国产化支持哪些数据库
我们支持南大通用数据库吗	国产化支持哪些数据库
国产化支持神舟通用吗	国产化支持哪些数据库
国产化支持神通数据库吗	国产化支持哪些数据库
国产化支持金仓数据库吗	国产化支持哪些数据库
达梦数据库可以部署在windows上吗	国产化支持哪些数据库
达梦主干环境构建找谁	国产化支持哪些数据库
是否支持南大通用	国产化支持哪些数据库
系统登录登录验证码图片不显示。	系统登录登录验证码图片不显示。
客户问题池找谁	客户问题池找谁
办理入职我要准备哪些材料	办理入职我要准备哪些材料
我要办理入职手续，请问需要什么材料	办理入职我要准备哪些材料
入职手续要什么证明材料	办理入职我要准备哪些材料
办一下入职需要准备什么	办理入职我要准备哪些材料
入职需要哪些材料啊	办理入职我要准备哪些材料
你知道办入职大概必须要哪几种材料吗	办理入职我要准备哪些材料
入职证明材料要什么	办理入职我要准备哪些材料
小e，你知道办入职手续要啥材料吗	办理入职我要准备哪些材料
请告诉我办入职必要的材料，我下周要入职了	办理入职我要准备哪些材料
有些技术问题或者客户需求想快速简单了解一下产品	有些技术问题或者客户需求想快速简单了解一下产品
这个需求是否已有开发计划？	这个需求是否已有开发计划？
日程相关问题	日程相关问题
看不到完成的日程	日程相关问题
日程手机同步	日程相关问题
日程可以可以批量导入信息吗	日程相关问题
日程元素的日程排序是根据什么排序的呢？是创建日程的先后顺序吗	日程相关问题
日程怎么导出	日程相关问题
日程怎么共享	日程相关问题
日程是否可以审批后才生效	日程相关问题
领导之间可以查看到互相之间的日程?	日程相关问题
word文档中打印无反应怎么解决	word文档中打印无反应怎么解决
系统登录支持em7的h5移动登录页面吗。	系统登录支持em7的h5移动登录页面吗。
谁是新疆大区总经理	谁是新疆大区总经理
我在标书制作过程中，有些技术、实施等问题不清楚，可以问谁	我在标书制作过程中，有些技术、实施等问题不清楚，可以问谁
标书中的技术问题咨询谁？	我在标书制作过程中，有些技术、实施等问题不清楚，可以问谁
标书中的技术问题不懂应该找谁咨询？	我在标书制作过程中，有些技术、实施等问题不清楚，可以问谁
标书中的实施问题咨询谁？	我在标书制作过程中，有些技术、实施等问题不清楚，可以问谁
标书中的实施问题不懂应该找谁咨询？	我在标书制作过程中，有些技术、实施等问题不清楚，可以问谁
督查事项是否可以通过流程创建？	督查事项是否可以通过流程创建？
谁是北方大区总经理	谁是北方大区总经理
我有朋友要加入泛微	我有朋友要加入泛微
我一哥们要加入泛微	我有朋友要加入泛微
我一姐妹要加入泛微	我有朋友要加入泛微
我家里亲戚要加入泛微	我有朋友要加入泛微
我的同学要加入泛微	我有朋友要加入泛微
我的闺蜜要加入泛微	我有朋友要加入泛微
我的发小要加入泛微	我有朋友要加入泛微
我的伙伴想要加入泛微	我有朋友要加入泛微
财务模块相关问题	财务模块相关问题
可靠的电子签名的大致过程是怎样的？	可靠的电子签名的大致过程是怎样的？
相邻节点不能自动穿透是什么原因？	相邻节点不能自动穿透是什么原因？
相邻节点无法自动穿透是因为什么？	相邻节点不能自动穿透是什么原因？
为什么相邻节点不能自动穿透？	相邻节点不能自动穿透是什么原因？
相邻节点自动穿透失败是什么引起的？	相邻节点不能自动穿透是什么原因？
相邻节点不能自动穿透怎么解决？	相邻节点不能自动穿透是什么原因？
年假有多少天	年假有多少天
查询年假天数	年假有多少天
我的年假有几天一共	年假有多少天
查一下我有没有年假，有几天	年假有多少天
你知道我还剩几天年假吗	年假有多少天
我想查一下我用了多少年假	年假有多少天
我一共用掉了几天年假，还剩多少	年假有多少天
快看看我的年假额度	年假有多少天
自定义查询中，当字段较多时，没有出现横向滚动条怎么回事？	自定义查询中，当字段较多时，没有出现横向滚动条怎么回事？
附件存储安全不安全	附件存储安全不安全
移动建模	移动建模
表单建模找谁	移动建模
谁负责表单建模	移动建模
项目实施过程中如何更好的与高层交流？	项目实施过程中如何更好的与高层交流？
我的桌子脏了，找谁清理	我的桌子脏了，找谁清理
5楼健身房太乱了	我的桌子脏了，找谁清理
地面要清理	我的桌子脏了，找谁清理
桌面要清洁	我的桌子脏了，找谁清理
垃圾要处理	我的桌子脏了，找谁清理
绿植要浇水	我的桌子脏了，找谁清理
我的桌子上有积水需要清理一下	我的桌子脏了，找谁清理
地板上都是水快给清理一下	我的桌子脏了，找谁清理
卫生间太脏了，打扫一下吧	我的桌子脏了，找谁清理
卫生间的马桶盖上太脏了	我的桌子脏了，找谁清理
2楼会议室地上好多瓜子壳，打扫一下	我的桌子脏了，找谁清理
202会议室的桌子上有好多水，打扫一下	我的桌子脏了，找谁清理
地面脏了	我的桌子脏了，找谁清理
会议室需要打扫啦	我的桌子脏了，找谁清理
会议室桌上有不少灰谁负责	我的桌子脏了，找谁清理
会议室有好多蟑螂啊	我的桌子脏了，找谁清理
请教一下软件测试流程方法有哪些	请教一下软件测试流程方法有哪些
分叉节点，一个人同时在多个分支上时，需要操作几次？	分叉节点，一个人同时在多个分支上时，需要操作几次？
e9新考勤是否支持人脸识别打卡。	e9新考勤是否支持人脸识别打卡。
我想开通更多人员的留言权限	我想开通更多人员的留言权限
我需要开通多人的留言权限	我想开通更多人员的留言权限
请帮我开通多人的留言权限	我想开通更多人员的留言权限
多人的留言权限如何开通	我想开通更多人员的留言权限
我要如何开通多人留言权限	我想开通更多人员的留言权限
开通多人留言权限的步骤	我想开通更多人员的留言权限
可以帮我开通多人留言权限吗	我想开通更多人员的留言权限
请为我开通多人留言权限	我想开通更多人员的留言权限
会议室设置相关问题	会议室设置相关问题
会议室如果冲突了，能设置成不允许提交吗	会议室设置相关问题
会议室设置中的负责人什么用	会议室设置相关问题
会议节点检测有什么作用	会议室设置相关问题
如何通知会议相关人	会议室设置相关问题
会议申请确认后，能够通过哪些途径通知相关人员?	会议室设置相关问题
会议决议怎样共享给未参会人员	会议室设置相关问题
会议有哪些身份，权限范围是哪些	会议室设置相关问题
会议监控的权限是哪个	会议室设置相关问题
会议短信发送失败	会议室设置相关问题
会议没有发送提醒	会议室设置相关问题
流程申请没有占用会议室	会议室设置相关问题
金格插件iweboffice2003支持wps和office混用吗	金格插件iweboffice2003支持wps和office混用吗
金格插件iweboffice2003支持wps和office公用吗	金格插件iweboffice2003支持wps和office混用吗
金格插件iweboffice2003支持wps和office一起用吗	金格插件iweboffice2003支持wps和office混用吗
金格插件iweboffice2003里wps和office可以一起用吗	金格插件iweboffice2003支持wps和office混用吗
老客户寄来需办理的合同收到了吗？	老客户寄来需办理的合同收到了吗？
老客户寄来合同收到了吗？	老客户寄来需办理的合同收到了吗？
老客户的合同寄过来了吗？	老客户寄来需办理的合同收到了吗？
老客户的合同盖章了吗？	老客户寄来需办理的合同收到了吗？
老客户的合同怎么还没到？	老客户寄来需办理的合同收到了吗？
帮我找一个老客户寄来的合同	老客户寄来需办理的合同收到了吗？
有位老客户的合同帮我盖章邮寄一下	老客户寄来需办理的合同收到了吗？
老客户的合同盖章要找谁？	老客户寄来需办理的合同收到了吗？
我要修改绩效考核方案	我要修改绩效考核方案
帮我修改下绩效考核方案	我要修改绩效考核方案
绩效考核方案可以修改吗	我要修改绩效考核方案
帮我改下绩效考核方案	我要修改绩效考核方案
改下绩效考核方案吧	我要修改绩效考核方案
我的绩效考核方案帮我改下	我要修改绩效考核方案
绩效考核方案如何修改	我要修改绩效考核方案
怎么修改绩效考核方案	我要修改绩效考核方案
费用报销漏提交或忘记提交，过了每月最晚提交日期	费用报销漏提交或忘记提交，过了每月最晚提交日期
我上个月的报销忘记提交了，这个月还可以提交吗	费用报销漏提交或忘记提交，过了每月最晚提交日期
延期报销可以吗	费用报销漏提交或忘记提交，过了每月最晚提交日期
报销忘记提交了怎么办	费用报销漏提交或忘记提交，过了每月最晚提交日期
报销忘记提交了	费用报销漏提交或忘记提交，过了每月最晚提交日期
费用报销漏提交或忘记提交了	费用报销漏提交或忘记提交，过了每月最晚提交日期
各个模块的负责人	各个模块的负责人
模块的负责人有谁	各个模块的负责人
人事考勤支持和哪些厂商的考勤机及考勤系统集成，是否有集成案例，是否考勤机型号的要求。	人事考勤支持和哪些厂商的考勤机及考勤系统集成，是否有集成案例，是否考勤机型号的要求。
协同区问题	协同区问题
协同区怎么选择到具体的流程	协同区问题
协同区怎么设置元素只取创建人申请的流程	协同区问题
协同区和协作区是一样的吗	协同区问题
预算编制完整导入和部分导入什么区别	预算编制完整导入和部分导入什么区别
人脸识别相关问题	人脸识别相关问题
人脸识别认证无法通过是什么情况，怎么办？	人脸识别相关问题
在手机短信打开签署链接进去后做人脸识别认证，摄像头无法启用？	人脸识别相关问题
人脸识别过程中无法启用摄像头找谁处理？	人脸识别相关问题
人脸识别时摄像头打不开？	人脸识别相关问题
mobile可以集成到第三方产品上吗	mobile可以集成到第三方产品上吗
企业微信集成	mobile可以集成到第三方产品上吗
em可以集成到微信吗	mobile可以集成到第三方产品上吗
考试前准备工作有哪些	考试前准备工作有哪些
要投标人员劳动合同	要投标人员劳动合同
我需要投标人员的劳动合同	要投标人员劳动合同
给我一份投标人员劳动合同	要投标人员劳动合同
可以发我投标人员劳动合同吗	要投标人员劳动合同
哪里可以找到投标人员劳动合同	要投标人员劳动合同
请发我一份投标人员劳动合同	要投标人员劳动合同
投标人员劳动合同请给我	要投标人员劳动合同
投标人员劳动合同有吗，有的话给我	要投标人员劳动合同
我要查奖金	我要查奖金
看一下奖金	我要查奖金
我奖金发了多少	我要查奖金
发奖金了没	我要查奖金
有奖金没	我要查奖金
如何看奖金	我要查奖金
在哪里查看奖金	我要查奖金
看一下年终奖金	我要查奖金
奖金怎么看啊	我要查奖金
契约锁架构问题	契约锁架构问题
培训视频下载地址找谁？	培训视频下载地址找谁？
新员工考核咨询谁？	新员工考核咨询谁？
新员工考核有问题找谁咨询？	新员工考核咨询谁？
新员工入职后怎么考核？	新员工考核咨询谁？
转正考试	新员工考核咨询谁？
android与其他app单点登录或者其他app单点登录到emobile app	android与其他app单点登录或者其他app单点登录到emobile app
安卓和其他程序单点登录或者其他app单点登录到emobile app	android与其他app单点登录或者其他app单点登录到emobile app
android和其他app登录或者其他app登录到emobile app	android与其他app单点登录或者其他app单点登录到emobile app
安卓与其他app单点登录还要其他app单点登录到emobile app	android与其他app单点登录或者其他app单点登录到emobile app
android和其他app单点登录或其他app登录至emobile app	android与其他app单点登录或者其他app单点登录到emobile app
电子投标相关问题联系谁？	电子投标相关问题联系谁？
电子投标相关问题可以咨询谁？	电子投标相关问题联系谁？
电子投标要走什么流程	电子投标相关问题联系谁？
电子投标怎么办理	电子投标相关问题联系谁？
什么时候进行电子投标	电子投标相关问题联系谁？
我可以电子投标吗	电子投标相关问题联系谁？
怎么操作进行电子投标	电子投标相关问题联系谁？
电子投标界面在哪	电子投标相关问题联系谁？
我想要个工作微博模板	我想要个工作微博模板
我想找个工作微博模板	我想要个工作微博模板
在哪里找工作微博模板	我想要个工作微博模板
能给我一份工作微博模板吗	我想要个工作微博模板
请发我一份工作微博模板	我想要个工作微博模板
可不可以发我工作微博模板	我想要个工作微博模板
工作微博模板你那边有吗，发我一份	我想要个工作微博模板
我急需工作微博模板	我想要个工作微博模板
附件存储规则是什么	附件存储规则是什么
移动建模引擎功能白皮书有吗	移动建模引擎功能白皮书有吗
有移动建模引擎功能相关的介绍吗	移动建模引擎功能白皮书有吗
移动建模引擎功能的有关说明	移动建模引擎功能白皮书有吗
我想咨询下移动建模引擎功能相关的问题	移动建模引擎功能白皮书有吗
契约锁人事问题找谁咨询	契约锁人事问题找谁咨询
契约锁人事相关问题咨询	契约锁人事问题找谁咨询
契约锁人事方面问题找谁？	契约锁人事问题找谁咨询
谁对契约锁人事问题比较熟悉？	契约锁人事问题找谁咨询
数据库报错	数据库报错
数据起不来了	数据库报错
数据库出问题了怎么办	数据库报错
系统数据丢了，需要恢复数据	数据库报错
oracle设置了每天自动备份，发现几次有的时候没有备份，这个会是什么原因	数据库报错
数据库磁盘空间满了	数据库报错
出差报销标准	出差报销标准
我明天要准备去北京，我的报销有标准吗	出差报销标准
我去外面出差的话可以报销多少，有什么标准吗	出差报销标准
我去出差路费有报销标准吗	出差报销标准
我上个月去北京出差的路费还没有给我报销，我的报销标准是多少	出差报销标准
我上个月刚来公司上班的，我有多少出差报销标准	出差报销标准
工作两年的员工的出差报销一半标准是多少	出差报销标准
我昨天出差去见客户请他吃了饭，1000块可以报销吗，有标准吗	出差报销标准
出差报销标准是怎么样的	出差报销标准
流程计划是这样设置的，但是触发的时间是现在这个时刻是什么原因	流程计划是这样设置的，但是触发的时间是现在这个时刻是什么原因
契约锁产品合法合规性	契约锁产品合法合规性
契约锁产品合规性找谁咨询？	契约锁产品合法合规性
契约锁产品法律原理找谁？	契约锁产品合法合规性
契约锁产品法律认可吗？	契约锁产品合法合规性
契约锁产品法律认定有效吗？	契约锁产品合法合规性
怎么创建需要审批的调查？	怎么创建需要审批的调查？
政务立项报告	政务立项报告
谁是华南一部总经理	谁是华南一部总经理
如何开通客户门户	如何开通客户门户
客户门户找谁开通	如何开通客户门户
谁负责管理客户门户的账号	如何开通客户门户
开通客户门户应该咨询谁	如何开通客户门户
我要打羽毛球	我要打羽毛球
下班后想组个队打羽毛球	我要打羽毛球
下班可以怎么报名打羽毛球啊	我要打羽毛球
公司给员工安排的打羽毛球场地在什么地方啊	我要打羽毛球
今年晚上公司有几个人一起打羽毛球啊	我要打羽毛球
我现在还可以报名今天晚上的羽毛球比赛吗	我要打羽毛球
公司每年的羽毛球大赛是什么时候啊	我要打羽毛球
公司下个月的羽毛球大赛怎么报名	我要打羽毛球
我今天特别想打羽毛球，请问怎么可以报名参加	我要打羽毛球
下班后我们公司同事一般可以去哪里打羽毛球啊	我要打羽毛球
用餐时间	用餐时间
公司的食堂饭菜不好吃	用餐时间
下午茶的饮料有哪些	用餐时间
下午茶我要喝可乐	用餐时间
早饭的馒头太大了	用餐时间
早饭的粥好烫，有没有温热的	用餐时间
以后早餐的鸡蛋能不能多备份一些，不够吃	用餐时间
早餐有茶叶蛋吗	用餐时间
早餐我想吃烧麦	用餐时间
早上吃的油条太硬了	用餐时间
下午茶的西瓜挺甜的	用餐时间
下午茶我们可以多放一些蛋糕	用餐时间
吃饭找谁	用餐时间
早饭时间	用餐时间
午饭时间	用餐时间
客户之前开发的一个功能要作废，帮忙处理下？	客户之前开发的一个功能要作废，帮忙处理下？
客户流程功能更改找谁？	客户之前开发的一个功能要作废，帮忙处理下？
客户更改流程功能需求找谁处理？	客户之前开发的一个功能要作废，帮忙处理下？
客户取消功能找谁？	客户之前开发的一个功能要作废，帮忙处理下？
契约锁代理商规则	契约锁代理商规则
契约锁代理商规则找谁了解？	契约锁代理商规则
契约锁代理商规则向谁咨询？	契约锁代理商规则
契约锁代理商规则是怎样的？	契约锁代理商规则
契约锁代理商制度问谁？	契约锁代理商规则
第三方硬件如何开票？	第三方硬件如何开票？
采购第三方硬件开票	第三方硬件如何开票？
第三方如何开票？	第三方硬件如何开票？
第三方硬件怎么开票？	第三方硬件如何开票？
第三方硬件要怎样开票？	第三方硬件如何开票？
第三方硬件的开票方式	第三方硬件如何开票？
第三方硬件开票找谁	第三方硬件如何开票？
第三方硬件的开票怎么解决	第三方硬件如何开票？
谁是银川机构总经理	谁是银川机构总经理
我对总部的日常情况还不够熟悉，应该找谁聊聊可以帮助我迅速融入泛微？	我对总部的日常情况还不够熟悉，应该找谁聊聊可以帮助我迅速融入泛微？
为什么我的项目移交被退回了？	为什么我的项目移交被退回了？
安装系统说明文档在哪里找	安装系统说明文档在哪里找
安装系统说明文档有吗	安装系统说明文档在哪里找
我要借用笔记本电脑	我要借用笔记本电脑
我上个月借的笔记本电脑还没有登记啊	我要借用笔记本电脑
帮我借一台笔记本电脑，我今天出差要用	我要借用笔记本电脑
帮我借一台性能比较好的笔记本电脑	我要借用笔记本电脑
帮我看看公司还有几台笔记本电脑可以外借的	我要借用笔记本电脑
我今天要去客户那边出差，帮我借一下笔记本电脑	我要借用笔记本电脑
昨天借的笔记本电脑我今天还要继续续借一台	我要借用笔记本电脑
麻烦你帮我借一下mac笔记本电脑	我要借用笔记本电脑
公司的笔记本电脑是都可以借的吗	我要借用笔记本电脑
如果有专业级费控的需求需要找人支持可以找谁?	如果有专业级费控的需求需要找人支持可以找谁?
费控专家有哪些？	如果有专业级费控的需求需要找人支持可以找谁?
我想查一下有空的费控专家	如果有专业级费控的需求需要找人支持可以找谁?
费控支持找谁？	如果有专业级费控的需求需要找人支持可以找谁?
专业级费控需求找支持？	如果有专业级费控的需求需要找人支持可以找谁?
升级合同提交什么流程？	升级合同提交什么流程？
如何升级合同	升级合同提交什么流程？
怎么升级合同呢	升级合同提交什么流程？
我想升级合同应该怎么操作	升级合同提交什么流程？
请帮我升级合同	升级合同提交什么流程？
谁知道合同升级怎么弄	升级合同提交什么流程？
合同升级应该提什么流程	升级合同提交什么流程？
你知道升级合同提哪个流程吗	升级合同提交什么流程？
流程开发问题找谁	流程开发问题找谁
e9pc客户端流程无法显示	流程开发问题找谁
履约保函如何开具	履约保函如何开具
请帮我开具履约保函证明	履约保函如何开具
履约保函信如何办理	履约保函如何开具
怎么办理银行保函	履约保函如何开具
履约事宜该找谁	履约保函如何开具
履约保函需要哪些信息	履约保函如何开具
履约函怎么开	履约保函如何开具
资信与履约函可以只开一个吗	履约保函如何开具
流程监控和流程类型统计表中的数据不一致的原因是什么？	流程监控和流程类型统计表中的数据不一致的原因是什么？
e8邮件撤回按钮在哪里	e8邮件撤回按钮在哪里
请问这个卖点如何理解？	请问这个卖点如何理解？
这个卖点有什么特殊亮点？	请问这个卖点如何理解？
这个卖点介绍如何下手？	请问这个卖点如何理解？
怎么去看待这个卖点？	请问这个卖点如何理解？
我要要个总结报告模板	我要要个总结报告模板
我想找个总结报告模板	我要要个总结报告模板
在哪里找总结报告模板	我要要个总结报告模板
能给我一份总结报告模板吗	我要要个总结报告模板
请发我一份总结报告模板	我要要个总结报告模板
可不可以发我总结报告模板	我要要个总结报告模板
总结报告模板你那边有吗，发我一份	我要要个总结报告模板
我急需总结报告模板	我要要个总结报告模板
我要打兵乓球	我要打兵乓球
下班了我们可以去哪里打乒乓球啊	我要打兵乓球
公司有乒乓球俱乐部吗	我要打兵乓球
我可以报名公司下个月的乒乓球比赛吗	我要打兵乓球
公司可以组织一次乒乓球比赛吗	我要打兵乓球
我想看看公司最近的乒乓球比赛是几月几号	我要打兵乓球
今天下班了有人一起打乒乓球吗	我要打兵乓球
帮我看看今天下午公司有没有人一起打乒乓球的	我要打兵乓球
公司乒乓球qq群是多少	我要打兵乓球
考试系统安装文件和数据库备份文件在哪里	考试系统安装文件和数据库备份文件在哪里
考试系统安装文件和数据库备份文件有吗	考试系统安装文件和数据库备份文件在哪里
考试系统安装文件在哪里下载	考试系统安装文件和数据库备份文件在哪里
考试系统数据库备份文件在哪里	考试系统安装文件和数据库备份文件在哪里
考勤数据同步问题是什么原因	考勤数据同步问题是什么原因
建模二开、需求评估问题	建模二开、需求评估问题
建模评估需求	建模二开、需求评估问题
建模二开评估人天	建模二开、需求评估问题
建模二次开发是否能实现	建模二开、需求评估问题
建模二次开发任务能否提前完成	建模二开、需求评估问题
建模二次开发排期到什么时候	建模二开、需求评估问题
建模需求评估流程什么时候能评估完	建模二开、需求评估问题
建模需求评估	建模二开、需求评估问题
评估建模二开所需的人天	建模二开、需求评估问题
怎么实现建模二次开发	建模二开、需求评估问题
建模二次开发如何实现	建模二开、需求评估问题
建模二次开发要多久完成	建模二开、需求评估问题
建模二次开发需要多少人天	建模二开、需求评估问题
建模需求评估大概要多久	建模二开、需求评估问题
你们能不能实现这个功能建模	建模二开、需求评估问题
签完的电子合同产生纠纷怎么办？	签完的电子合同产生纠纷怎么办？
财务自定义流程搭建完成后，在流转过程中预算没有被冻结，生效	财务自定义流程搭建完成后，在流转过程中预算没有被冻结，生效
契约锁产品可以和哪些系统进行对接	契约锁产品可以和哪些系统进行对接
契约锁对接相关问题找谁？	契约锁产品可以和哪些系统进行对接
印控仪可以跟契约锁哪些平台对接？	契约锁产品可以和哪些系统进行对接
e-office产品使用相关问题	e-office产品使用相关问题
e-office产品使用咨询谁？	e-office产品使用相关问题
e-office客户问题找谁解决？	e-office产品使用相关问题
e-office客户bug反馈找谁协助？	e-office产品使用相关问题
e-office需求建议联系谁	e-office产品使用相关问题
报销单如果存在问题的话，找谁来处理	报销单如果存在问题的话，找谁来处理
报销单有误找谁咨询？	报销单如果存在问题的话，找谁来处理
报销单信息不对怎么解决？	报销单如果存在问题的话，找谁来处理
我对报销单信息有点疑问可以找谁咨询？	报销单如果存在问题的话，找谁来处理
我有很好的市场推广建议,该告诉谁来做宣传	我有很好的市场推广建议,该告诉谁来做宣传
市场推广找谁咨询？	我有很好的市场推广建议,该告诉谁来做宣传
有市场推广建议可以联系谁？	我有很好的市场推广建议,该告诉谁来做宣传
市场推广相关问题咨询谁？	我有很好的市场推广建议,该告诉谁来做宣传
市场推广建议怎么宣传？	我有很好的市场推广建议,该告诉谁来做宣传
推荐奖励多少钱	推荐奖励多少钱
推荐奖励有钱吗	推荐奖励多少钱
推荐员工入职给多少钱	推荐奖励多少钱
推荐人员入职的奖金是多少	推荐奖励多少钱
推荐成功有奖金吗	推荐奖励多少钱
推荐成功的奖金是多少	推荐奖励多少钱
推荐朋友入职有奖励吗	推荐奖励多少钱
推荐的朋友入职成功会发奖金吗	推荐奖励多少钱
我推荐了朋友入职奖金大概是多少	推荐奖励多少钱
推荐的奖励怎么组成的	推荐奖励多少钱
合同归档了吗？	合同归档了吗？
合同归档是谁负责的？	合同归档了吗？
新客户的合同归档了吗？	合同归档了吗？
请问新合同归档到哪了？	合同归档了吗？
归档后的合同去哪找啊？	合同归档了吗？
我想找一下我签的合同哪些已经归档了	合同归档了吗？
合同归档的相关问题联系谁？	合同归档了吗？
合同归档需要走什么流程	合同归档了吗？
这个新合同怎么归档？	合同归档了吗？
e-office的售前、商务等相关事宜（包括代理商）	e-office的售前、商务等相关事宜（包括代理商）
e-office售前相关问题找谁咨询？	e-office的售前、商务等相关事宜（包括代理商）
e-office代理问题找谁咨询？	e-office的售前、商务等相关事宜（包括代理商）
e-office商务合作联系谁？	e-office的售前、商务等相关事宜（包括代理商）
流程浏览不到客户卡片怎么办？	流程浏览不到客户卡片怎么办？
我看不到客户的名片信息怎么回事	流程浏览不到客户卡片怎么办？
流程浏览不到客户的个人信息	流程浏览不到客户卡片怎么办？
客户卡片不在流程上？	流程浏览不到客户卡片怎么办？
怎么显示不了客户的名片信息	流程浏览不到客户卡片怎么办？
流程/知识模块设置了邮件提醒，怎么不会进行邮件提醒呐？	流程/知识模块设置了邮件提醒，怎么不会进行邮件提醒呐？
云桥能够集成的企业应用有哪些	云桥能够集成的企业应用有哪些
云桥会务系统应用后台只能是saas应用吗？	云桥能够集成的企业应用有哪些
契约锁解决了公章使用的哪些缺陷？	契约锁解决了公章使用的哪些缺陷？
契约锁解决了传统实体公章的哪些使用问题？	契约锁解决了公章使用的哪些缺陷？
契约锁相对于公章有哪些优势	契约锁解决了公章使用的哪些缺陷？
我要领个动态令牌ukey	我要领个动态令牌ukey
我想换一个新的动态令牌	我要领个动态令牌ukey
我的动态令牌显示屏已经花掉了	我要领个动态令牌ukey
我找谁换动态令牌啊	我要领个动态令牌ukey
我的动态令牌被压坏了怎么可以换一个啊	我要领个动态令牌ukey
去哪里可以领取动态令牌	我要领个动态令牌ukey
去前台可以领动态令牌吗	我要领个动态令牌ukey
我上个月不在公司，我的动态令牌忘记拿了	我要领个动态令牌ukey
售前文档	售前文档
通讯录怎么同步	通讯录怎么同步
我想同步通讯录	通讯录怎么同步
通讯录同步怎么搞	通讯录怎么同步
通讯录同步怎么办	通讯录怎么同步
邮件每页显示数量怎么修改显示多一点	邮件每页显示数量怎么修改显示多一点
我们的流程标准功能有哪些	我们的流程标准功能有哪些
我们做过涉密内网项目吗	我们做过涉密内网项目吗
e9如何与企业微信、钉钉集成	e9如何与企业微信、钉钉集成
督查督办通用改造及重新开启需求问题找谁	督查督办通用改造及重新开启需求问题找谁
公章管理过程存在的风险有哪些	公章管理过程存在的风险有哪些
公章管理中有哪些风险	公章管理过程存在的风险有哪些
管理公章有哪些缺陷	公章管理过程存在的风险有哪些
契约锁项目体系	契约锁项目体系
在流程或者在建模里面新建浏览按钮字段时提示错误，是什么原因导致的？	在流程或者在建模里面新建浏览按钮字段时提示错误，是什么原因导致的？
新客户合同审核/合同预审	新客户合同审核/合同预审
新客户合同怎么审核？	新客户合同审核/合同预审
新客户的合同审核了吗？	新客户合同审核/合同预审
新客户的合同预审了吗？	新客户合同审核/合同预审
新客户的合同审核通过了吗？	新客户合同审核/合同预审
新客户合同审核的相关问题咨询谁？	新客户合同审核/合同预审
新客户合同预审的相关问题联系谁呢？	新客户合同审核/合同预审
新客户的合同审核有什么问题吗？	新客户合同审核/合同预审
邮件回执如何设置	邮件回执如何设置
ecology产品相关培训与考核安排	ecology产品相关培训与考核安排
我想知道报销标准	我想知道报销标准
你可以告诉我报销标准吗	我想知道报销标准
我们部门的报销标准是多少	我想知道报销标准
我的报销标准是多少	我想知道报销标准
为什么我的报销标准只有1000块	我想知道报销标准
我来公司已经两年了，为什么我的报销标注还是1000	我想知道报销标准
我们部门准备出去旅游，我们的报销标准是多少	我想知道报销标准
我打车的报销标准是多少	我想知道报销标准
我这个月的报销额度和标准是什么	我想知道报销标准
我陪客户一起吃饭的钱可以报销吗，有什么标准吗	我想知道报销标准
公司总裁是谁	公司总裁是谁
我们公司的总裁是哪个	公司总裁是谁
公司老板是谁	公司总裁是谁
契约锁私有化系统相关问题	契约锁私有化系统相关问题
契约锁私有化系统的特点？	契约锁私有化系统相关问题
契约锁私有化系统的应用场景	契约锁私有化系统相关问题
客户递交了试用申请，但是在系统里找不到，怎么办	客户递交了试用申请，但是在系统里找不到，怎么办
客户的试用申请找不到是怎么回事？	客户递交了试用申请，但是在系统里找不到，怎么办
客户的试用申请还没有收到是什么原因？	客户递交了试用申请，但是在系统里找不到，怎么办
系统里找不到客户的试用申请是什么原因？	客户递交了试用申请，但是在系统里找不到，怎么办
系统里为什么看不到客户提交的试用申请？	客户递交了试用申请，但是在系统里找不到，怎么办
如何办理停车牌	如何办理停车牌
停车证办好了找谁去拿	如何办理停车牌
停车证在几楼办理	如何办理停车牌
停车证明天能办好吗	如何办理停车牌
我上周申请的停车证，这周能办下来吗	如何办理停车牌
我昨天办理的停车证今天还没收到	如何办理停车牌
联系行政给我一张停车证	如何办理停车牌
办理停车证是去行政那边吗	如何办理停车牌
停车证可以用时几辆车用啊	如何办理停车牌
一张停车证只能用在一辆车上吗	如何办理停车牌
停车证的有效期是多久啊	如何办理停车牌
新打开“写作交流”，协作列表的高级搜索的结果没有清空的原因是什么	新打开“写作交流”，协作列表的高级搜索的结果没有清空的原因是什么
附件位置如何获取	附件位置如何获取
e9流程明细较多，比较慢，有什么好的方案吗？	e9流程明细较多，比较慢，有什么好的方案吗？
公文管理相关问题	公文管理相关问题
收发文问题咨询谁	公文管理相关问题
收发文应该问谁	公文管理相关问题
e9如何根据选择框字段，联动公文种类和主题分类	公文管理相关问题
e9公文种类和主题分类的表名	公文管理相关问题
公文流程新建的时候提示请选择文档存放目录，但是目录已经设置了	公文管理相关问题
公文督办如何实现?	公文管理相关问题
公文催办如何实现	公文管理相关问题
公文正文怎么控制打印份数	公文管理相关问题
公文模块的收文查询中为什么没有内容？	公文管理相关问题
公文归档你们如何实现的?	公文管理相关问题
为什么公文套红节点不显示套红相关按钮	公文管理相关问题
公文的正文能不能直接显示,而不是再次点击进去	公文管理相关问题
公文流程设置好了，仍然显示【未指定】，是哪里没弄好	公文管理相关问题
公文正文生成以后打不开	公文管理相关问题
什么是哈希（hash）算法和哈希值？	什么是哈希（hash）算法和哈希值？
电子签章集成oa功能	电子签章集成oa功能
电子签章与oa集成	电子签章集成oa功能
e9中嵌入电子签章	电子签章集成oa功能
pdf附件下载下来打不开是什么原因？	pdf附件下载下来打不开是什么原因？
pdf附件打不开是因为什么？	pdf附件下载下来打不开是什么原因？
pdf附件下载后无法打开怎么解决？	pdf附件下载下来打不开是什么原因？
pdf附件下载后打不开找谁处理？	pdf附件下载下来打不开是什么原因？
pdf附件能下载但不能打开是因为什么？	pdf附件下载下来打不开是什么原因？
视频密码问题	视频密码问题
培训视频地址及密码	视频密码问题
视频的解压密码找谁？	视频密码问题
培训视频的密码在哪里找？	视频密码问题
共享页面，显示列定制，在笔记本这种小屏幕上显示不全怎么解决	共享页面，显示列定制，在笔记本这种小屏幕上显示不全怎么解决
页面上的按钮怎么实现触发自定义动作	页面上的按钮怎么实现触发自定义动作
页面上的按钮如何做到触发自定义动作	页面上的按钮怎么实现触发自定义动作
我要开工作证明	我要开工作证明
工作证明应该找公司的谁啊	我要开工作证明
工作证明要多久可以拿到啊	我要开工作证明
公司可以给我开一个工作证明吗，我要去银行办业务需要	我要开工作证明
工作证明一般都是找人事吗	我要开工作证明
公司有工作证明吗	我要开工作证明
你好，我已经离职了还可以开工作证明吗	我要开工作证明
工作证明可以开几个月的啊	我要开工作证明
我要查工资	我要查工资
怎么看工资	我要查工资
看下工资多少	我要查工资
工资怎么看	我要查工资
查我上个月的工资	我要查工资
可以看下工资吗	我要查工资
工资如何查	我要查工资
看一下工资发了多少	我要查工资
显示我的工资	我要查工资
看下我工资清单	我要查工资
e-office产品开发意见和产品需求咨询	e-office产品开发意见和产品需求咨询
想要电子投标合同扫描件	想要电子投标合同扫描件
电子合同扫描件找谁要？	想要电子投标合同扫描件
需要电子合同扫描件走什么流程？	想要电子投标合同扫描件
我想要这个电子合同的扫描件去找谁	想要电子投标合同扫描件
电子投标合同扫描的相关问题要联系谁	想要电子投标合同扫描件
我的电子投标合同帮我扫描了吗	想要电子投标合同扫描件
这个电子投标合同能扫描吗	想要电子投标合同扫描件
今天可以扫描电子投标合同吗	想要电子投标合同扫描件
财务报告在哪查询	财务报告在哪查询
看下财务报告	财务报告在哪查询
怎么看财务报告	财务报告在哪查询
哪里可以看到财务报告	财务报告在哪查询
找谁要财务报告	财务报告在哪查询
如何查询财务报告	财务报告在哪查询
财务报告怎么查	财务报告在哪查询
我要查询财务报告	财务报告在哪查询
公文签章问题	公文签章问题
电子签章	公文签章问题
能否实现公文的多部门会签?	公文签章问题
为什么公文正文点击签章按钮没有反应	公文签章问题
谁是广州二部总经理	谁是广州二部总经理
什么是可靠的电子签名？	什么是可靠的电子签名？
行政	行政
行政相关问题	行政
我要咨询行政相关的问题	行政
我需要行政支持	行政
支持的国产中间件有哪些	支持的国产中间件有哪些
中间件支持东方通吗	支持的国产中间件有哪些
中间件支持中创吗	支持的国产中间件有哪些
浏览器兼容问题找谁	浏览器兼容问题找谁
哪些人有审批协作的权限？	哪些人有审批协作的权限？
消息服务连接不上？	消息服务连接不上？
消息服务连接失败？	消息服务连接不上？
消息服务连不上了？	消息服务连接不上？
消息服务连接不成功？	消息服务连接不上？
契约锁成本计算	契约锁成本计算
e8督查督办如何申请	e8督查督办如何申请
消息中心是否支持第三方接入？	消息中心是否支持第三方接入？
售前支持成本是多少，与销售业绩里售前成本不一致？	售前支持成本是多少，与销售业绩里售前成本不一致？
售前支持成本怎么核算的？	售前支持成本是多少，与销售业绩里售前成本不一致？
售前支持成本核算标准是怎样的？	售前支持成本是多少，与销售业绩里售前成本不一致？
售前支持成本如何估计？	售前支持成本是多少，与销售业绩里售前成本不一致？
售前支持成本是按什么标准进行估计的？	售前支持成本是多少，与销售业绩里售前成本不一致？
售前支持成本核算找谁？	售前支持成本是多少，与销售业绩里售前成本不一致？
我的售前支持成本和销售业绩里的售前成本为什么是不一样的？	售前支持成本是多少，与销售业绩里售前成本不一致？
销售业绩里的售前成本就是实际的售前成本吗？	售前支持成本是多少，与销售业绩里售前成本不一致？
供应商的款项支付了吗	供应商的款项支付了吗
我想看看供应商的款项支付了没有	供应商的款项支付了吗
给供应商付款了吗	供应商的款项支付了吗
上周采购的电脑有没有付款	供应商的款项支付了吗
公司供应商的支付款到了吗	供应商的款项支付了吗
公司采购的付款情况	供应商的款项支付了吗
办公用品供应商的款项支付情况	供应商的款项支付了吗
有没有给食品供应商付款	供应商的款项支付了吗
阿里云的负责人	阿里云的负责人
阿里云谁负责？	阿里云的负责人
阿里云问题找谁？	阿里云的负责人
谁负责阿里云	阿里云的负责人
涉及到技术层面和技术合作的问题，需要找谁来处理	涉及到技术层面和技术合作的问题，需要找谁来处理
技术合作相关问题找谁协助？	涉及到技术层面和技术合作的问题，需要找谁来处理
技术合作找谁咨询？	涉及到技术层面和技术合作的问题，需要找谁来处理
技术层面的问题咨询谁？	涉及到技术层面和技术合作的问题，需要找谁来处理
我想了解一下技术层面的问题应该找谁？	涉及到技术层面和技术合作的问题，需要找谁来处理
云桥怎么迁移	云桥怎么迁移
云桥迁移怎么搞	云桥怎么迁移
云桥要迁移我该怎么办	云桥怎么迁移
云桥如何迁移	云桥怎么迁移
这个月的补丁包什么时候发布？	这个月的补丁包什么时候发布？
云桥怎么升级	云桥怎么升级
云桥如何升级	云桥怎么升级
云桥要怎么升级	云桥怎么升级
云桥升级怎么办	云桥怎么升级
客户说部门里面有人的话做了离职处理不能封存，把人移到别的地方封存也不行，只能通过删除才能封存，但是现在不想通过删除来实现是什么原因	客户说部门里面有人的话做了离职处理不能封存，把人移到别的地方封存也不行，只能通过删除才能封存，但是现在不想通过删除来实现是什么原因
我看到公司的一个视频宣传，需要源文件，找谁要？	我看到公司的一个视频宣传，需要源文件，找谁要？
不同版本的建模应用能不能互相导入使用	不同版本的建模应用能不能互相导入使用
如何规避传统签章存在的管理风险点？	如何规避传统签章存在的管理风险点？
有什么办法规避传统签章的管理风险	如何规避传统签章存在的管理风险点？
中安消分权后，后台文档目录看不到怎么解决	中安消分权后，后台文档目录看不到怎么解决
我怎么知道e-office系统有哪些新功能	我怎么知道e-office系统有哪些新功能
e-office系统新功能有哪些？	我怎么知道e-office系统有哪些新功能
e-office新功能怎么查询？	我怎么知道e-office系统有哪些新功能
在哪里可以查看e-office新增功能？	我怎么知道e-office系统有哪些新功能
怎么查询e-office新增功能？	我怎么知道e-office系统有哪些新功能
e-office新功能咨询谁？	我怎么知道e-office系统有哪些新功能
e-office新增了哪些功能？	我怎么知道e-office系统有哪些新功能
e-office公司产品有哪些功能？	我怎么知道e-office系统有哪些新功能
申请licence只剩下质保期尾款未结清，也只能申请临时三个月？	申请licence只剩下质保期尾款未结清，也只能申请临时三个月？
查一下我的licence的有效期是多久	申请licence只剩下质保期尾款未结清，也只能申请临时三个月？
我能申请多久的licence	申请licence只剩下质保期尾款未结清，也只能申请临时三个月？
小e,能给我讲一下临时licence的使用期限是多少	申请licence只剩下质保期尾款未结清，也只能申请临时三个月？
申请licence只能申请临时三个月？	申请licence只剩下质保期尾款未结清，也只能申请临时三个月？
质保期尾款未结清，也只能申请临时三个月？	申请licence只剩下质保期尾款未结清，也只能申请临时三个月？
申请licence只剩下质保期尾款未结清，申请licence也只能申请临时三个月？	申请licence只剩下质保期尾款未结清，也只能申请临时三个月？
申请licence的时间最长为多久？	申请licence只剩下质保期尾款未结清，也只能申请临时三个月？
在项目中，有些功能不理解该怎么办	在项目中，有些功能不理解该怎么办
项目中对功能有疑问怎么办？	在项目中，有些功能不理解该怎么办
项目中对功能不理解怎么办？	在项目中，有些功能不理解该怎么办
项目中对功能有疑问找谁协助？	在项目中，有些功能不理解该怎么办
项目中有的功能不理解应该找谁咨询？	在项目中，有些功能不理解该怎么办
我要劳动合同	我要劳动合同
看一下我的劳动合同	我要劳动合同
小e，我想查看一下我入职时签的合同	我要劳动合同
我的劳动合同给我看一下	我要劳动合同
查看我的劳动合同	我要劳动合同
我来公司时签的合约可不可以给我看看	我要劳动合同
能给我查看我的劳动合约吗	我要劳动合同
打开我的劳动合同	我要劳动合同
二次开发扣款对应哪个流程？二次开发成本是多少？	二次开发扣款对应哪个流程？二次开发成本是多少？
二次开发的成本应该怎么结算	二次开发扣款对应哪个流程？二次开发成本是多少？
客户要二次开发怎么收款	二次开发扣款对应哪个流程？二次开发成本是多少？
客户需要二次开发，成本估计是多少	二次开发扣款对应哪个流程？二次开发成本是多少？
出现二次开发的情况，我们按什么标准收取费用	二次开发扣款对应哪个流程？二次开发成本是多少？
二次开发扣款走什么流程？	二次开发扣款对应哪个流程？二次开发成本是多少？
二次开发成本是多少？	二次开发扣款对应哪个流程？二次开发成本是多少？
二次开发成本如何进行核算？	二次开发扣款对应哪个流程？二次开发成本是多少？
客户要进行二次开发，该提交什么流程？	二次开发扣款对应哪个流程？二次开发成本是多少？
性能问题找谁?	性能问题找谁?
系统出现性能问题了	性能问题找谁?
性能相关问题	性能问题找谁?
高可用、高并发的资料找哪位同事可以帮忙找下	性能问题找谁?
客户管理及客户卡片相关问题	客户管理及客户卡片相关问题
如何修改客户状态	客户管理及客户卡片相关问题
客户状态怎么修改	客户管理及客户卡片相关问题
如何配置客户卡片相关操作的审批流程	客户管理及客户卡片相关问题
客户模块中的产品设置能设置不同级别的产品吗?怎么设置?	客户管理及客户卡片相关问题
客户卡片配置	客户管理及客户卡片相关问题
客户的行业设置是否可以添加?	客户管理及客户卡片相关问题
我需要添加客户的行业配置	客户管理及客户卡片相关问题
如何添加客户的行业	客户管理及客户卡片相关问题
客户门户能否自定义菜单和门户首页，客户门户是否支持移动端登录	客户管理及客户卡片相关问题
客户卡片是否支持字段联动	客户管理及客户卡片相关问题
自定义字段是否支持导入	客户管理及客户卡片相关问题
客户卡片相关字段的配置	客户管理及客户卡片相关问题
客户卡片字段导入	客户管理及客户卡片相关问题
在客户管理中新建合同后怎样进行审批?	客户管理及客户卡片相关问题
在客户卡片上点击“申请-基础客户”时，页面出现提示：此客户类型没有相关的审批流程?	客户管理及客户卡片相关问题
个体工商户如何进行认证？	个体工商户如何进行认证？
契约锁怎么进行个体工商户认证？	个体工商户如何进行认证？
建模数据权限如何控制	建模数据权限如何控制
建模数据权限如何管控	建模数据权限如何控制
如何管控建模数据权限	建模数据权限如何控制
怎么管控建模数据的权限	建模数据权限如何控制
云商店下错模块如何处理？	云商店下错模块如何处理？
合同审批流程怎么走	合同审批流程怎么走
合同审批走什么流程？	合同审批流程怎么走
合同审批找谁	合同审批流程怎么走
客户云商店明细表批导格式不正确是没有反应的问题	客户云商店明细表批导格式不正确是没有反应的问题
文档目录自定义字段存储哪张表？如何查看	文档目录自定义字段存储哪张表？如何查看
文档目录自定义字段存储哪张表？怎么查看	文档目录自定义字段存储哪张表？如何查看
如何查看文档目录自定义字段存储哪张表？	文档目录自定义字段存储哪张表？如何查看
怎么看文档目录自定义字段存储哪张表？	文档目录自定义字段存储哪张表？如何查看
咋看文档目录自定义字段存储哪张表？	文档目录自定义字段存储哪张表？如何查看
我要申请车辆补贴	我要申请车辆补贴
我这个月还可以申请车辆补贴吗	我要申请车辆补贴
每个月的车辆补贴是多少	我要申请车辆补贴
为什么我上个月的车辆补贴少了很多	我要申请车辆补贴
我们公司是不是每个月都有车辆补贴啊	我要申请车辆补贴
我上个月没来公司上班也可以报销车辆补贴吗	我要申请车辆补贴
每个月的车辆补贴是直接打到我的工资卡里吗	我要申请车辆补贴
我这个月的车辆补贴为什么还没有到账啊	我要申请车辆补贴
后端，催办设置，流程触发，催办主题名称没有展示为英文的问题如何解决	后端，催办设置，流程触发，催办主题名称没有展示为英文的问题如何解决
在收款未结算表中写未归档是什么情况？	在收款未结算表中写未归档是什么情况？
收款未结算表中的未归档是什么意思？	在收款未结算表中写未归档是什么情况？
收款未结算表中的未归档是指什么？	在收款未结算表中写未归档是什么情况？
收款未结算表中的未归档意味着什么？	在收款未结算表中写未归档是什么情况？
收款未结算表中的未归档说明什么？	在收款未结算表中写未归档是什么情况？
收款未结算表中写未归档是什么原因？	在收款未结算表中写未归档是什么情况？
收款未结算表中写未归档是因为什么？	在收款未结算表中写未归档是什么情况？
为什么在收款未结算表中还有未归档这一项？	在收款未结算表中写未归档是什么情况？
e9新功能介绍，有详细资料吗？	e9新功能介绍，有详细资料吗？
要投标人员社保证明	要投标人员社保证明
我需要投标人员的社保证明	要投标人员社保证明
给我一份投标人员社保证明	要投标人员社保证明
可以发我投标人员社保证明吗	要投标人员社保证明
哪里可以找到投标人员社保证明	要投标人员社保证明
请发我一份投标人员社保证明	要投标人员社保证明
投标人员社保证明请给我	要投标人员社保证明
投标人员社保证明有吗，有的话给我	要投标人员社保证明
我要办理居住证积分	我要办理居住证积分
你知道居住证积分怎么办吗	我要办理居住证积分
我想办理一下居住证的积分	我要办理居住证积分
申请一下，办理居住证积分	我要办理居住证积分
我来上海工作三年了，帮我办一下办居住证积分	我要办理居住证积分
你好，我要申请居住证积分办理	我要办理居住证积分
小e，我要办我的居住证积分	我要办理居住证积分
要办理居住证积分需要什么材料	我要办理居住证积分
emessage开发任务是否能够提前交付	emessage开发任务是否能够提前交付
政务专家	政务专家
统一待办中心的相关问题	统一待办中心的相关问题
统一待办中心功能是如何实现的	统一待办中心的相关问题
统一待办中心客户端流程消息推送如何实现的	统一待办中心的相关问题
统一待办中心客户端流程消息推送有需求说明文档吗	统一待办中心的相关问题
契约锁合同金额	契约锁合同金额
契约锁顾问找谁	契约锁顾问找谁
资信证明如何办理	资信证明如何办理
帮我拉银行流水证明	资信证明如何办理
办理我的资信证明	资信证明如何办理
办理信贷要哪些资料	资信证明如何办理
去银行购买支票要什么证明	资信证明如何办理
我要申请办理资信证明	资信证明如何办理
我要开资信证明	资信证明如何办理
我想要资信证明	资信证明如何办理
我签的合同里，涉及到广告交换，怎么处理	我签的合同里，涉及到广告交换，怎么处理
合同中广告交换协议找谁咨询？	我签的合同里，涉及到广告交换，怎么处理
签合同涉及广告交换相关问题联系谁？	我签的合同里，涉及到广告交换，怎么处理
广告交换协议可以咨询谁？	我签的合同里，涉及到广告交换，怎么处理
签合同时广告交换的问题可以向谁了解？	我签的合同里，涉及到广告交换，怎么处理
角色权限相关表结构咨询。	角色权限相关表结构咨询。
开发框架失败找谁	开发框架失败找谁
谁是湖南大区总经理	谁是湖南大区总经理
使用云商店明细增强插件无法保存数据怎么办	使用云商店明细增强插件无法保存数据怎么办
永中的控件服务器有什么配置要求	永中的控件服务器有什么配置要求
谁是ebu项目开发总监	谁是ebu项目开发总监
奖杯到哪里领	奖杯到哪里领
今年公司的金牌用户评选已经出来了，给我申请一下奖杯	奖杯到哪里领
我要申请一下奖杯给公司这个季度的金牌用户	奖杯到哪里领
申请一下发放奖杯给这个月的优秀项目推广及管理员	奖杯到哪里领
年度优秀项目推广及管理员是我的下属，申请一下奖杯	奖杯到哪里领
把年度优秀项目推广及管理员奖杯给李林	奖杯到哪里领
金牌用户奖杯申领一下	奖杯到哪里领
申请一下要给最佳用户的金牌用户奖杯	奖杯到哪里领
查下我的绩效指标	查下我的绩效指标
看下我的业绩指标	查下我的绩效指标
我的业绩指标完成了多少	查下我的绩效指标
我这个月的业绩指标多少	查下我的绩效指标
这个月的业绩指标完成了吗	查下我的绩效指标
业绩指标完成情况	查下我的绩效指标
看一下业绩指标情况	查下我的绩效指标
查询业绩指标	查下我的绩效指标
我们团队本月的业绩指标是多少	查下我的绩效指标
我们这个月业绩指标多吗	查下我的绩效指标
看下业绩指标吧	查下我的绩效指标
我的业绩完成多少了	查下我的绩效指标
我的业绩指标是多少	查下我的绩效指标
怎么看我的绩效指标	查下我的绩效指标
我的绩效指标哪里看	查下我的绩效指标
绩效指标能看吗	查下我的绩效指标
怎么无法看我的绩效指标	查下我的绩效指标
绩效指标怎么评的	查下我的绩效指标
社保公积金怎么转移	社保公积金怎么转移
小e，我的社保之前在别的城市，怎么转过来呀	社保公积金怎么转移
住房公积金怎么从其他城市转到上海来	社保公积金怎么转移
我想问一下社会保险的转移办法	社保公积金怎么转移
我要申请转移我的社保和公积金	社保公积金怎么转移
你知道怎么在城市之间转移社保吗？请告诉我	社保公积金怎么转移
你好，我可以把社保和公积金转过来吗，怎么转	社保公积金怎么转移
我想知道如何转移我的社会保险和住房公积金	社保公积金怎么转移
如果把我的社保从南京转到上海，要怎么做	社保公积金怎么转移
能不能查一下如何转移公积金	社保公积金怎么转移
多家公司主体怎么注册契约锁账号？	多家公司主体怎么注册契约锁账号？
如果我有多家公司主体，要注册多个账号吗？还是可以在一个账号里面切换？	多家公司主体怎么注册契约锁账号？
我要采购物品	我要采购物品
新建第三方采购需求	我要采购物品
咖啡没了	我要采购物品
我要采购	我要采购物品
我要买礼品	我要采购物品
买咖啡	我要采购物品
公司的笔记本没有了	我要采购物品
最近需要采购一批电话	我要采购物品
办公用品采购	我要采购物品
购买打印机	我要采购物品
电脑购买	我要采购物品
办公区域的空调购买	我要采购物品
想要产品说明是找你吗	想要产品说明是找你吗
微搜	微搜
商务	商务
商务相关问题	商务
商务问题	商务
咨询商务问题找谁	商务
客户的产品培训还有名额么？	客户的产品培训还有名额么？
系统启动不起来找谁	系统启动不起来找谁
还需要开具多少发票？	还需要开具多少发票？
剩余欠票额在哪里查询？	还需要开具多少发票？
在哪里可以查我的剩余欠票额？	还需要开具多少发票？
查询剩余欠票额找谁？	还需要开具多少发票？
查一下我还有哪些发票没有开？	还需要开具多少发票？
请问我还有多少发票没有开？	还需要开具多少发票？
请问我应该怎么查我没有开具的发票？	还需要开具多少发票？
我应该开多少发票？	还需要开具多少发票？
我们搬了新的办公地址，需要更改联系信息该找谁	我们搬了新的办公地址，需要更改联系信息该找谁
更改联系信息找谁咨询？	我们搬了新的办公地址，需要更改联系信息该找谁
更改办公信息联系谁？	我们搬了新的办公地址，需要更改联系信息该找谁
更新联系信息咨询谁？	我们搬了新的办公地址，需要更改联系信息该找谁
谁负责员工联系信息？	我们搬了新的办公地址，需要更改联系信息该找谁
第三方系统如何接入消息中心？	第三方系统如何接入消息中心？
报销出问题了怎么办	报销出问题了怎么办
报销流程已归档却没收到报销款怎么办	报销出问题了怎么办
报销流程归档但没收到报销款是为何	报销出问题了怎么办
报销流程已归档却没收到报销款是什么原因	报销出问题了怎么办
流程归档却还没收到报销款怎么办	报销出问题了怎么办
报销流程没收到款怎么回事	报销出问题了怎么办
归档的报销流程款项未到账怎么办	报销出问题了怎么办
归档的报销流程款项未到账什么原因	报销出问题了怎么办
归档的报销流程款项未到账怎么回事	报销出问题了怎么办
我的报销流程归档了，却还没收到报销款怎么办	报销出问题了怎么办
报销流程归档但没收到报销款是怎么回事呢	报销出问题了怎么办
报销归档后，银行未有短信提醒，费用报销是否打款	报销出问题了怎么办
已发生借款导入报错	已发生借款导入报错
想要纸质投标合同扫描件	想要纸质投标合同扫描件
这个纸质投标合同帮我扫描一下	想要纸质投标合同扫描件
我想要这个纸质投标合同的扫描件去找谁	想要纸质投标合同扫描件
纸质投标合同扫描的相关问题要联系谁	想要纸质投标合同扫描件
我的纸质投标合同帮我扫描了吗	想要纸质投标合同扫描件
这个纸质投标合同能扫描吗	想要纸质投标合同扫描件
今天可以扫描纸质投标合同吗	想要纸质投标合同扫描件
把纸质投标合同扫描件发给我	想要纸质投标合同扫描件
招投标文件所需的各类资质审核的证书找谁要	招投标文件所需的各类资质审核的证书找谁要
资质审核证书谁有？	招投标文件所需的各类资质审核的证书找谁要
资质审核证书找谁咨询？	招投标文件所需的各类资质审核的证书找谁要
招投标资质证书找谁要？	招投标文件所需的各类资质审核的证书找谁要
招投标资质审核证书谁有？	招投标文件所需的各类资质审核的证书找谁要
薪资查看是否支持了二次密码验证	薪资查看是否支持了二次密码验证
为什么会议流程归档了，会议室没有占用呢？	为什么会议流程归档了，会议室没有占用呢？
为什么归档会议过程，会议室没有占用呢	为什么会议流程归档了，会议室没有占用呢？
为什么存档会议进程，会议室没有被占用呢	为什么会议流程归档了，会议室没有占用呢？
会议过程已归档，会议室未占用	为什么会议流程归档了，会议室没有占用呢？
为什么会议流程已归档且会议室未被占用	为什么会议流程归档了，会议室没有占用呢？
我们支持哪几种国产数据库	我们支持哪几种国产数据库
咱们系统支持达梦数据库吗	我们支持哪几种国产数据库
你们支持什么数据库?	我们支持哪几种国产数据库
我们3万人用，数据库服务器你们建议oracle还是sql?	我们支持哪几种国产数据库
我们支持oracle数据库吗	我们支持哪几种国产数据库
e9支持国产数据库吗	我们支持哪几种国产数据库
多语言支持sql数据库吗	我们支持哪几种国产数据库
我们3万人用，数据库服务器你们建议oracle还是sql	我们支持哪几种国产数据库
我们支持什么版本的mysql	我们支持哪几种国产数据库
国产化数据库软件的支持情况	我们支持哪几种国产数据库
支持wps吗	支持wps吗
扫码签到问题	扫码签到问题
国产化找谁	国产化找谁
国产化改造部署要求有哪些	国产化找谁
国产化解决方案	国产化找谁
e8支持国产化吗	国产化找谁
文档中心元素tab页上新增未读文档提醒有需求说明吗	文档中心元素tab页上新增未读文档提醒有需求说明吗
在分部矩阵中加了单文本的发票代码，为什么在矩阵维护中显示不出来	在分部矩阵中加了单文本的发票代码，为什么在矩阵维护中显示不出来
自定义报表相关问题	自定义报表相关问题
流程自定义报表可以设置个人的金额合计吗	自定义报表相关问题
流程自定义报表统计怎么出现这种现象了	自定义报表相关问题
流程自定义报表为什么查不到数据	自定义报表相关问题
怎样触发流程进行数据审批	怎样触发流程进行数据审批
如何触发流程进行统计数据核准	怎样触发流程进行数据审批
怎样做才能触发流程进行数据审核	怎样触发流程进行数据审批
系统多语言相关问题	系统多语言相关问题
系统是否支持小语种	系统多语言相关问题
为什么小语种只支持oracle的数据库	系统多语言相关问题
系统是否支持韩语	系统多语言相关问题
我们系统支不支持日语	系统多语言相关问题
是否支持越南语	系统多语言相关问题
我的名片制作好了没	我的名片制作好了没
名片作好了吗	我的名片制作好了没
查一下名片做好了吗	我的名片制作好了没
查下名片ok了吗	我的名片制作好了没
我的名片还要多久才能好啊	我的名片制作好了没
我昨天制作的名片好了吗	我的名片制作好了没
我上周提交制作的名片今天可以拿得到吗	我的名片制作好了没
名片现在制作到哪一步啦	我的名片制作好了没
名片还要多久才能拿得到啊	我的名片制作好了没
我的名片下周可以取到吗	我的名片制作好了没
流程关联了预算后提交报错	流程关联了预算后提交报错
投标相关需要付款，走什么流程	投标相关需要付款，走什么流程
竞标项目需要付款，找谁啊	投标相关需要付款，走什么流程
投标成功需要付一部分款项	投标相关需要付款，走什么流程
付款流程怎么申请	投标相关需要付款，走什么流程
投标花的钱，需要怎么报账	投标相关需要付款，走什么流程
我们这次该怎么向公司申请投标花费的金额	投标相关需要付款，走什么流程
投标需要付款	投标相关需要付款，走什么流程
投标需要付款如何操作	投标相关需要付款，走什么流程
什么是sap	什么是sap
sap	什么是sap
解释下sap	什么是sap
我要领生孩子礼物	我要领生孩子礼物
我上周刚生完孩子，公司会有这方面的福利吗	我要领生孩子礼物
我今年1月份生的孩子，这方面的福利我还有吗	我要领生孩子礼物
我现在就想看看我生育福利	我要领生孩子礼物
公司对于女员工生育这块会有什么样的福利安排啊	我要领生孩子礼物
公司对男员工会有什么生育福利吗	我要领生孩子礼物
我老婆今年刚生的孩子，我会有什么福利待遇吗	我要领生孩子礼物
我老婆生孩子，那我也会享受到公司的福利待遇吗	我要领生孩子礼物
我要领取一下我的生育方面的福利	我要领生孩子礼物
特殊-其他	特殊-其他
他是阿里云的负责人	特殊-其他
流程给到谁就找谁	特殊-其他
这个需要联系一下客户那边的负责人	特殊-其他
提问题的账号的是客户那边的负责人	特殊-其他
那调用插件慢这个问题要找谁	特殊-其他
那我现在应该联系谁	特殊-其他
帮我查一下下周的日程	特殊-其他
我不舒服明天要请假	特殊-其他
打电话给年假	特殊-其他
打开记一笔	特殊-其他
下周的日程	特殊-其他
总经理的日程	特殊-其他
最大的会议室在几楼	特殊-其他
昨日签约新闻	特殊-其他
总部会议室	特殊-其他
天气如何	特殊-其他
打开三斤	特殊-其他
亲爱的	特殊-其他
退出	特殊-其他
结束我	特殊-其他
来一波客户我知道	特殊-其他
明天上午8点对	特殊-其他
明天上午9点吧	特殊-其他
明天上午9点到后天上午	特殊-其他
那你喜欢我吗	特殊-其他
那你也少	特殊-其他
那年	特殊-其他
那是我们放荡	特殊-其他
那他会把那个嗯我刚刚说的一些话的一些信息直接	特殊-其他
那铁壶	特殊-其他
内部留言图桶	特殊-其他
嫩说话的艺术一	特殊-其他
能帮我找一个一般的演示账号吗	特殊-其他
能饿我找找看熊手机号你肯定要跟电线张宇不一样的只是长得不一样而已	特殊-其他
能量守恒定律	特殊-其他
你nb	特殊-其他
你tmd还不如siri聪明	特殊-其他
你啊	特殊-其他
你爱我吗	特殊-其他
你比有时不	特殊-其他
你不懂	特殊-其他
你不好	特殊-其他
你不好签到	特殊-其他
你的胃	特殊-其他
你的我的我的我	特殊-其他
你老情	特殊-其他
你们是以包头肯为空	特殊-其他
你目标	特殊-其他
你那店主说	特殊-其他
你能给我创建手机上的闹钟吗	特殊-其他
你你	特殊-其他
你你跟那个表哥先商量着上网	特殊-其他
你你是不是特难于丹带衣服了	特殊-其他
你牛	特殊-其他
你漂亮吗	特殊-其他
你欠揍	特殊-其他
你去讲	特殊-其他
你去了什么教训	特殊-其他
你让谁给我闻闻呀18个	特殊-其他
你傻逼吧	特殊-其他
全部审批掉	特殊-其他
全部应用	特殊-其他
泉州市这个娃子	特殊-其他
确认工作微博	特殊-其他
确认我有	特殊-其他
确认之后	特殊-其他
我要按着说	特殊-其他
我要把他	特殊-其他
我要办理	特殊-其他
我要办文	特殊-其他
我要鼻子	特殊-其他
我要吃屎	特殊-其他
我要出差或者我要会议这些东西你都可以去说都可以去说啊	特殊-其他
我要滴滴打车	特殊-其他
我要发起	特殊-其他
我要发文	特殊-其他
我要放鞭炮	特殊-其他
我要退出	特殊-其他
我要文档不要文档你傻着吗	特殊-其他
我要先	特殊-其他
我要学习项目一千问	特殊-其他
我要云盘云旁	特殊-其他
我要找我的云盘应用	特殊-其他
我要注销	特殊-其他
我早上10点	特殊-其他
我找	特殊-其他
我这	特殊-其他
我这边我也很开心	特殊-其他
学校毕业设计嗯开题指导	特殊-其他
学校做毕设	特殊-其他
雪松很帅	特殊-其他
寻找	特殊-其他
巡	特殊-其他
亚	特殊-其他
呀	特殊-其他
言	特殊-其他
研究	特殊-其他
研究智能相关的技术以及第三方供应商	特殊-其他
掩饰	特殊-其他
验证发票	特殊-其他
一717移动门户平台	特殊-其他
一ip	特殊-其他
一lp专家是谁	特殊-其他
一rap	特殊-其他
一百	特殊-其他
一边是家	特殊-其他
一场展会	特殊-其他
一点点点	特殊-其他
一高二会议室坐的是谁	特殊-其他
一个	特殊-其他
一个人	特殊-其他
一激励	特殊-其他
一今天工作	特殊-其他
一就有两个菜谱号吃全鱼宴呢你	特殊-其他
一口理解流程接口	特殊-其他
一摸包中的小一	特殊-其他
一你	特殊-其他
一票出手	特殊-其他
一切靠特	特殊-其他
一扫码验票	特殊-其他
一少	特殊-其他
一天到	特殊-其他
一条热电	特殊-其他
一一乘以一亿除以	特殊-其他
一一乘以一亿等于几	特殊-其他
一一一扫	特殊-其他
一一一一打死你个龟孙儿	特殊-其他
一怎么	特殊-其他
一中心两平台	特殊-其他
伊利宕机问题早晨监控忘记签到	特殊-其他
以前的岗位结果	特殊-其他
怎么	特殊-其他
怎么行动	特殊-其他
怎么会出来了啊	特殊-其他
怎么叫做微	特殊-其他
怎么金龙汇通	特殊-其他
怎么就要即时通讯群	特殊-其他
怎么客户目录出现了我一个问题	特殊-其他
怎么去撕b时	特殊-其他
站位	特殊-其他
张辉老板说	特殊-其他
张宇我想同步通讯录	特殊-其他
长子里的吗	特殊-其他
找	特殊-其他
找到很委屈些	特殊-其他
找你看啊	特殊-其他
找人早晨进少	特殊-其他
找下上实城开的事情	特殊-其他
找一份泛微的公司简介	特殊-其他
找一首	特殊-其他
找一下房地产发了几个房地产的几个饭	特殊-其他
这呵呵	特殊-其他
这就是我说的没有按照他的规则去做	特殊-其他
这里面阿邦	特殊-其他
这时候他们没办法去看我来跟他对话功能如果他不懂我可以教他就旁边有个小箭头就是类似于客服就好了	特殊-其他
这事	特殊-其他
这是个女孩很高的室友	特殊-其他
这也是吗	特殊-其他
这一大早我就去了	特殊-其他
这种找一个谭小平的合同这么厉害像现在这种制度你那就不用了	特殊-其他
浙江大学爱你	特殊-其他
只是这句话啊退出你给他	特殊-其他
只有一个日程	特殊-其他
只找你	特殊-其他
知道	特殊-其他
知道结果	特殊-其他
知道啥意思啊	特殊-其他
知啦啦	特殊-其他
知识	特殊-其他
知识积累	特殊-其他
知识门户	特殊-其他
直接说就可以然后它就会识别	特殊-其他
智能指数分析	特殊-其他
中	特殊-其他
中不中	特殊-其他
中钢西重联系人过生日	特殊-其他
重新登录	特殊-其他
周强的工作为	特殊-其他
10月11号上午10点。	特殊-其他
你给我发一个	特殊-其他
我不太明白	特殊-其他
嗯，把明天带你给啥？	特殊-其他
流程类型为明天。	特殊-其他
番外出牛城。	特殊-其他
他们不知道	特殊-其他
我要吃	特殊-其他
mahao	特殊-其他
这对你选择产品的时候连选了一块9，就迷信，里面还有一块1角。	特殊-其他
请教啊	特殊-其他
生完项目。	特殊-其他
契约	特殊-其他
还不爱吗？	特殊-其他
帮我买个卡。	特殊-其他
为什么呀。	特殊-其他
为什么吃饭？	特殊-其他
卡。	特殊-其他
知道。	特殊-其他
切你妈的道	特殊-其他
怎么每次，关掉后台应用就要退出，就要重新验证？	特殊-其他
大卡	特殊-其他
哇咔。	特殊-其他
到。	特殊-其他
你到？	特殊-其他
安康。	特殊-其他
真的。	特殊-其他
擦了，公司谁最丑？	特殊-其他
钱对。	特殊-其他
泛微的女神是谁	特殊-其他
泛微的男神是谁	特殊-其他
找那也没	特殊-其他
我们公司谁最帅？	特殊-其他
外宿柳橙	特殊-其他
都好勤。	特殊-其他
今天是工作日吗？	特殊-其他
流程保存失败	特殊-其他
智能办公楼。	特殊-其他
外出神器。	特殊-其他
嗯，那个，啊，徐涛拿来的歌曲啊，帮我申请一个外出流程，申请外出流程，啊，听一下，唉，不晓得是什么？	特殊-其他
找一个外出聊天。	特殊-其他
明天出相关客户范围。	特殊-其他
明天早上9点到12点无锡销售部所有同事	特殊-其他
新建客户听	特殊-其他
天天见上海的。	特殊-其他
帮我打给我的钱卡。	特殊-其他
然后明天上午9点到12点	特殊-其他
明天下午12点	特殊-其他
明天上午8点半到下午6点	特殊-其他
早上9点到中午12点	特殊-其他
canyouspeakenglish	特殊-其他
二傻子啊	特殊-其他
给不给他打电话	特殊-其他
小玉之手什么时候可以开始卖	特殊-其他
小议助手什么时候开始开可以开始卖	特殊-其他
什么时候可以开始销售这个	特殊-其他
下午今天上午的事	特殊-其他
等客户	特殊-其他
我请青岛	特殊-其他
自从副本不	特殊-其他
春节	特殊-其他
明天9点后天下午4点	特殊-其他
明天下午两点半	特殊-其他
后天下午3点半	特殊-其他
付出	特殊-其他
查找最新版本	特殊-其他
产检	特殊-其他
产品架构	特殊-其他
产品升级八个	特殊-其他
产品退出	特殊-其他
常用的	特殊-其他
常在河边走还不是孩子爹	特殊-其他
成都一笔又一波	特殊-其他
我的业绩不对或者业绩需要拆分贡献比例，业绩核算调整找谁	我的业绩不对或者业绩需要拆分贡献比例，业绩核算调整找谁
业绩有问题找谁咨询？	我的业绩不对或者业绩需要拆分贡献比例，业绩核算调整找谁
业绩拆分咨询谁？	我的业绩不对或者业绩需要拆分贡献比例，业绩核算调整找谁
业绩核算有误联系谁？	我的业绩不对或者业绩需要拆分贡献比例，业绩核算调整找谁
业绩核算有误怎么解决？	我的业绩不对或者业绩需要拆分贡献比例，业绩核算调整找谁
我对业绩核算结果有点疑问找谁咨询？	我的业绩不对或者业绩需要拆分贡献比例，业绩核算调整找谁
文档消息推送失败	文档消息推送失败
文档消息推送有问题	文档消息推送失败
文档消息推送报错	文档消息推送失败
文档消息推送实现不了	文档消息推送失败
谁是青岛机构总经理	谁是青岛机构总经理
请问客户想做门户开发，设计支持应该找谁，走什么流程	请问客户想做门户开发，设计支持应该找谁，走什么流程
门户开发设计支持咨询谁？	请问客户想做门户开发，设计支持应该找谁，走什么流程
客户做门户开发需要设计支持找谁？	请问客户想做门户开发，设计支持应该找谁，走什么流程
请问客户想做网站专题，设计应该找谁，走什么流程	请问客户想做门户开发，设计支持应该找谁，走什么流程
客户想做网站需要设计支持找谁？	请问客户想做门户开发，设计支持应该找谁，走什么流程
网站设计支持找谁？	请问客户想做门户开发，设计支持应该找谁，走什么流程
产品白皮书等技术资料有吗	产品白皮书等技术资料有吗
系统登录支持ca登录吗。	系统登录支持ca登录吗。
已收款未结算是什么情况？	已收款未结算是什么情况？
已收款未结算是什么意思？	已收款未结算是什么情况？
已收款未结算是什么原因？	已收款未结算是什么情况？
已收款未结算是怎么回事？	已收款未结算是什么情况？
为什么会显示已收款未结算？	已收款未结算是什么情况？
为什么系统说已收款未结算？	已收款未结算是什么情况？
收款和结算有什么区别吗？	已收款未结算是什么情况？
收款和结算的区别是什么？	已收款未结算是什么情况？
请帮我制作名片	请帮我制作名片
怎么申请做名片	请帮我制作名片
印刷名片	请帮我制作名片
小e帮我申请一下名片	请帮我制作名片
我的名片上面的信息错了，要给我修改一下	请帮我制作名片
经理的名片名字弄错了，得重新制作一下	请帮我制作名片
我名片上的号码换了，要换一下名片	请帮我制作名片
制作名片应该找谁啊	请帮我制作名片
我今天刚入职，要制作名片	请帮我制作名片
出差流程没提怎么办	出差流程没提怎么办
小e，我昨天出差忘了提交出差流程了，怎么办	出差流程没提怎么办
我想起来上周五出差没有提流程，怎么补交呀	出差流程没提怎么办
怎么办呢，今天外出没提流程	出差流程没提怎么办
周一拜访客户忘记提交外出流程了，如何处理	出差流程没提怎么办
昨天临时去客户那处理问题，没来得及提交出差流程，我该怎么做呢	出差流程没提怎么办
上个月有次出差忘记提流程该怎么办	出差流程没提怎么办
前天去万达开会没提外出流程，应该怎么办呢	出差流程没提怎么办
契约锁项目问题	契约锁项目问题
软件功能如何快速测试？	软件功能如何快速测试？
有个客户需要参观复星、太保	有个客户需要参观复星、太保
要投标人员简历	要投标人员简历
我需要投标人员的简历	要投标人员简历
给我一份投标人员简历	要投标人员简历
可以发我投标人员简历吗	要投标人员简历
哪里可以找到投标人员简历	要投标人员简历
请发我一份投标人员简历	要投标人员简历
投标人员简历请给我	要投标人员简历
投标人员简历有吗，有的话给我	要投标人员简历
客户要求多公司分摊合同金额，发票如何操作？	客户要求多公司分摊合同金额，发票如何操作？
发票上的公司信息可以分多家公司填写吗	客户要求多公司分摊合同金额，发票如何操作？
客户要求多公司分摊合同金额，发票怎么操作？	客户要求多公司分摊合同金额，发票如何操作？
客户要求多公司分摊合同金额，发票怎样操作？	客户要求多公司分摊合同金额，发票如何操作？
客户要求多公司分摊合同金额可以吗？	客户要求多公司分摊合同金额，发票如何操作？
客户要求多公司分摊合同金额如何操作？	客户要求多公司分摊合同金额，发票如何操作？
客户要求多公司分摊合同金额怎么操作？	客户要求多公司分摊合同金额，发票如何操作？
契约锁演示环境	契约锁演示环境
契约锁demo搭建	契约锁演示环境
移动门户问题	移动门户问题
在门户中可以显示所有文档中的最新5条吗	移动门户问题
门户管理的要点说明	移动门户问题
移动门户配好了，如果移动端要出来，还要做什么操作	移动门户问题
移动门户能够以列表形式显示设置的门户吗	移动门户问题
你们有移动门户吗?	移动门户问题
门户菜单问题，菜单显示不正确	移动门户问题
直接把整个页面放到门户菜单里是怎么设置的	移动门户问题
如果客户只能够看到顶部一个门户菜单，怎么解决?	移动门户问题
协同区用的是文档内容元素，在后台选出了文档内容后，前台不能显示是怎么回事	移动门户问题
你们门户集成主要集成什么内容?	移动门户问题
门户主题与元素问题	移动门户问题
元素样式能随着主题切换而变化吗	移动门户问题
门户元素字体怎么调呀	移动门户问题
请问一个门户元素左边显示图片，右边显示文字的元素是文档中心元素吗	移动门户问题
客户不想让用户在登录后页面中自由拖动门户元素显示位置，是在哪里配置的？	移动门户问题
你们的门户元素都是文档信息吗?	移动门户问题
门户主题切换出错	移动门户问题
门户元素不能编辑怎么办	移动门户问题
请帮忙把这份资料刻录成光盘	请帮忙把这份资料刻录成光盘
刻录一下昨天会议的光盘	请帮忙把这份资料刻录成光盘
录一下培训课程的光盘	请帮忙把这份资料刻录成光盘
我想刻录上周培训的光盘	请帮忙把这份资料刻录成光盘
帮我刻录上周我们参加会议的光盘	请帮忙把这份资料刻录成光盘
我说我想刻个光盘	请帮忙把这份资料刻录成光盘
帮我申请一下刻个光盘	请帮忙把这份资料刻录成光盘
我希望找人帮我刻光盘	请帮忙把这份资料刻录成光盘
能不能刻录一下我们昨天部门的聚会	请帮忙把这份资料刻录成光盘
我能把我的工作内容刻成光盘吗	请帮忙把这份资料刻录成光盘
我要申请明天刻光盘	请帮忙把这份资料刻录成光盘
调查已经生效了，但是想要提前结束调查，该去哪里设置？	调查已经生效了，但是想要提前结束调查，该去哪里设置？
角色成员可以按照分部、部门范围添加吗	角色成员可以按照分部、部门范围添加吗
权限转移相关问题	权限转移相关问题
权限转移中的数字是什么意思	权限转移相关问题
智能印控介绍有吗	智能印控介绍有吗
解释下智能印控	智能印控介绍有吗
当年合同业绩如何查询？	当年合同业绩如何查询？
怎么查询我的合同业绩？	当年合同业绩如何查询？
在哪里可以查询我的合同业绩？	当年合同业绩如何查询？
今年我签了哪些合同？	当年合同业绩如何查询？
今年我签的所有合同报表？	当年合同业绩如何查询？
查询合同业绩找谁？	当年合同业绩如何查询？
今年我签的全部合同在哪里查看？	当年合同业绩如何查询？
今年我的签约业绩怎么样？	当年合同业绩如何查询？
会议数据为什么没有生成？	会议数据为什么没有生成？
会议数据为什么没有填充？？	会议数据为什么没有生成？
会议数据为什么并未生成？？	会议数据为什么没有生成？
会议数据为什么并未转化？？	会议数据为什么没有生成？
会议数据为什么并未填充？？	会议数据为什么没有生成？
老客户合同模版在哪里？	老客户合同模版在哪里？
哪里找老客户合同模板	老客户合同模版在哪里？
谁有老客户合同模板	老客户合同模版在哪里？
老客户合同模板找谁要	老客户合同模版在哪里？
我想要老客户合同模板找谁	老客户合同模版在哪里？
哪里能下载老客户合同模板	老客户合同模版在哪里？
谁有老客户的合同模板	老客户合同模版在哪里？
老客户合同模板怎么下载	老客户合同模版在哪里？
