2019-07-30 16:38:54.625718
请问预算周期指的什么，设置每月或每季度有什么影响吗	已收款未结算是什么情况？	为什么机构结算款金额和付款金额不一致？
督查督办数据导入不成功怎么办？	怎样触发流程进行数据审批	我要修改什么默认设置项，在系统哪张表？
会议室排座功能有实现计划吗	为什么会议流程归档了，会议室没有占用呢？	下午有个算法工程师来面试，帮忙接待下
使用云商店明细增强插件无法保存数据怎么办	金格插件iweboffice2003支持wps和office混用吗	登录页面问题
契约锁解决了公章使用的哪些缺陷？	契约锁产品合法合规性	契约锁产品可以和哪些系统进行对接
有关于集成钉钉的移动考勤方案吗？	移动端问题咨询	云桥和钉钉、微信企业号、微信服务号怎么集成
建模培训问题	建模二开、需求评估问题	能否用建模实现xx功能
科目为什么在流程中选不到	流程超时相关问题	项目流程创建不成功
数据到期了如何发送相关提醒	会议室发出的短信提醒配置问题	流程超时相关问题
oa的流程表单是否可以转pdf？	流程流转相关问题	我要修改什么默认设置项，在系统哪张表？
预算模块-财务做账这边操作对象，选择不了是为什么	已收款未结算是什么情况？	售前支持成本是多少，与销售业绩里售前成本不一致？
凭证推送如何配置	推荐奖励多少钱	我要推荐
结束状态的协作还可以发表协作交流吗？	协同区问题	我的这个功能的流程到你这里了，我看测试人是你，还没有收到相关功能的包？
个体工商户如何进行认证？	要投标人员资质证书	泛微网络开票信息
怎么实现云桥集成轻推显示出待办/抄送的未读数呢？	oa申请了非标准功能【统一待办中心】，第3方系统要如何将待办消息推送到oa？	云桥怎么集成微信
请问市场活动设计物料支持，应该找谁，走什么流程	请问客户想做门户开发，设计支持应该找谁，走什么流程	如何配置客户卡片相关操作的审批流程
督办消息中心主键冲突怎么解决	消息服务连接不上？	e-office常见的内部平台访问地址有哪些？
员工报销和供应商付款管理能否对接银企直联系统，进行自动化结算?	提交的流程何时可以付款	报销归档后，银行未有短信提醒，费用报销是否打款
你们门户集成主要集成什么内容?	系统集成方面的技术咨询	请问客户想做门户开发，设计支持应该找谁，走什么流程
财务自定义流程搭建完成后，在流转过程中预算没有被冻结，生效	流程流转相关问题	已收款未结算是什么情况？
我们的项目是科研类项目，需要在项目中期进行项目中期评审，你们是如何支撑的?	二次开发扣款对应哪个流程？二次开发成本是多少？	项目实施成本是多少？
考试流程视频在哪里找	视频密码问题	流程测试相关问题
国产化电脑在线编辑正文需要哪些条件	我们支持哪些国产操作系统	日程相关问题
为什么不建议使用mysql?	mysql初始化过程有异常	我们支持哪几种国产数据库
异构系统的表单可不可以作为列表和浏览按钮在oa里显示出来	门户菜单问题，菜单显示不正确	系统集成方面的技术咨询
人脸识别认证无法通过是什么情况，怎么办？	没有税号能开票吗？	我想更换系统信息
在分部矩阵中加了单文本的发票代码，为什么在矩阵维护中显示不出来	发票丢了怎么办？	发票相关问题
已发生借款导入报错	资产导入报错	日程相关问题
新员工考核咨询谁？	我要修改绩效考核方案	我的业绩指标是多少
正文的选择框目录怎样才能选择到字段	文档目录自定义字段存储哪张表？如何查看	流转过程中公文的展示问题
图片显示不出来及无法下载附件的问题如何解决	附件无法上传问题	我要换系统照片
在项目管理中,可以录入项目预算.但如何录入项目实际花费的金额呢?	项目实施成本是多少？	我们的项目管理模块，项目状态是谁有权限修改的
契约锁实名认证有问题找谁？	契约锁产品可以和哪些系统进行对接	契约锁产品合法合规性
客户是内网的情况上，是否可以通过开放端口实现企业微信的使用，具体要开放哪些端口呢？	移动端问题咨询	我想开通流程权限
预算相关功能涉及的表结构有么	为什么我实现不了这个功能，我配置哪里有问题？	系统集成方面的技术咨询
如何修改客户状态	怎样修改资产信息?	客户之前开发的一个功能要作废，帮忙处理下？
预算里面的控制节点啥意思	为什么机构结算款金额和付款金额不一致？	已收款未结算是什么情况？
云商店显示异常问题	物业公司的人过来了，请安排相关人员对接下	我办公室的空调坏了
ie下打印时，弹出确认提示？	系统中病毒了找谁	项目创建菜单为空白
我想查找泛微logo文件	我有朋友要加入泛微	门户元素不能编辑怎么办？
预算科目中关联对象选择的是项目有什么作用	售前支持成本是多少，与销售业绩里售前成本不一致？	为什么机构结算款金额和付款金额不一致？
如何验证电子签章有效性？	公文签章问题	契约锁产品合法合规性
oa流程归档后，流程表单、附件、正文，是否可以归档到中信档案系统、量子档案系统、紫光档案系统、中软档案系统？	流程数据归档怎样转到建模	报销归档后，银行未有短信提醒，费用报销是否打款
正文转pdf为什么不成功	我要转正	履约保函如何开具
我们的流程标准功能有哪些	流程测试相关问题	为什么我实现不了这个功能，我配置哪里有问题？
人员搜索支持姓名全拼搜索需求有说明吗	微搜为什么搜索不到数据？	日程共享为什么无效?
正文的模板，选择框模板无法保存	我想要个工作微博模板	我想了解特殊激励制度
在客户管理中新建合同后怎样进行审批?	客户要求多公司分摊合同金额，发票如何操作？	契约锁产品合法合规性
如何使用客户公海	客户用户数不够用，可以多申请吗？	如何开通客户门户
考勤数据同步问题是什么原因	我考勤数据错了	系统显示缺勤怎么办
权限转移相关问题	流程流转相关问题	社保公积金怎么转移
督查督办e8e9有何区别？	我要修改什么默认设置项，在系统哪张表？	开启分权后目录的维护权限怎么不生效了？
资产入库不成功，生成不了资产	资产要清理数据，重新导入	资产导入报错
你们的项目管理模块支持网络图和甘特图吗?	我们的项目管理模块，项目状态是谁有权限修改的	项目流程创建不成功
你们的系统能够做工程项目管理吗?颗粒度能够管理到多细?	我们支持哪几种国产数据库	我们的项目管理模块，项目状态是谁有权限修改的
企业号集成问题	系统集成方面的技术咨询	如何开通客户门户
流程触发集成	系统集成方面的技术咨询	为什么我实现不了这个功能，我配置哪里有问题？
多家公司主体怎么注册契约锁账号？	契约锁产品可以和哪些系统进行对接	客户要求多公司分摊合同金额，发票如何操作？
e8发文库的文号 签发人如何才能显示	公文管理相关问题	文档目录自定义字段存储哪张表？如何查看
微搜部署失败	微搜为什么搜索不到数据？	请问手机客户端登录不上怎么处理？
项目任务分解问题	项目流程创建不成功	协同区问题
oa流程接口文档说明	系统集成方面的技术咨询	e-office实施过程中如何搭建外网访问oa系统？
部署em7，e9不能开放外网怎么办	em7问题	em7下载安装问题
人脸识别时摄像头打不开？	如何变更照片？	我要换银行卡号
请问户外广告设计，应该找谁，走什么流程	请问客户想做门户开发，设计支持应该找谁，走什么流程	金格插件iweboffice2003支持wps和office混用吗
如果我们资产管理系统，你们的资产流程能够自动生成资产台账码?	资产要清理数据，重新导入	资产导入报错
如何排查金格插件的兼容性问题	金格插件iweboffice2003支持wps和office混用吗	我要领个动态令牌ukey
oa是否可以与多个ad域集成，能否实现多域用户登录认证，多域的组织架构和人员信息同步到oa这样的需求？	系统集成方面的技术咨询	e-office实施过程中如何搭建外网访问oa系统？
微搜在哪里控制可搜索的模块	微搜为什么搜索不到数据？	请问手机客户端登录不上怎么处理？
手机会议新建功能	移动端问题咨询	会议室发出的短信提醒配置问题
如何通过移动建模引擎实现个性化配置？	移动建模引擎功能白皮书有吗	移动建模产品咨询，配置，需求相关问题？
异构系统的表单能不能作为列表和浏览按钮展示在oa里	门户菜单问题，菜单显示不正确	系统集成方面的技术咨询
e9如何与第三方app集成	如何集成第三方h5应用？	系统集成方面的技术咨询
mysql的集群部署方案	mysql初始化过程有异常	我们支持哪几种国产数据库
客户是否可以单独购买考勤功能而不购买e-cology	a4纸用完了，请帮忙再采购些	我想知道请假制度
我们本地有国产化测试环境吗	流程测试相关问题	我们支持哪些国产操作系统
如何根据文档id获取文档真实存放路径脚本	文档目录自定义字段存储哪张表？如何查看	公文管理相关问题
系统内核算项目相关的业务数据问题	我们支持哪几种国产数据库	系统集成方面的技术咨询
微搜功能支持pdf中的内容作为关键字被搜索出来吗	微搜为什么搜索不到数据？	android与其他app单点登录或者其他app单点登录到emobile app
通过标准的api修改只读字段，保存不上？	android与其他app单点登录或者其他app单点登录到emobile app	我要修改什么默认设置项，在系统哪张表？
目前有没有客户做过和企业微信集成的案例？	在哪里可以查看到契约锁案例？	android原生app的集成开发相关问题？
会议申请确认后，能够通过哪些途径通知相关人员?	会议数据为什么没有生成？	我的这个功能的流程到你这里了，我看测试人是你，还没有收到相关功能的包？
预算编制的时候提交审批报错，提示没有权限	已收款未结算是什么情况？	售前支持成本是多少，与销售业绩里售前成本不一致？
e9流程明细较多，比较慢，有什么好的方案吗？	流程超时相关问题	流程功能包开发进度咨询谁？
oa上了非标准功能【统一认证中心】，第3方系统是否需要开发，能否提供开发资料？	系统集成方面的技术咨询	第3方系统如何单点登录oa，有几种方式，能提供相应的方案吗？
流程触发集成问题	系统集成方面的技术咨询	为什么我实现不了这个功能，我配置哪里有问题？
预算导入时报错，请问这个是因为什么	资产导入报错	售前支持成本是多少，与销售业绩里售前成本不一致？
能否通过系统配置实现银企直连，如付款成功，能否生成付款核算凭证，传送到财务系统?	提交的流程何时可以付款	银行承兑汇票如何核算业绩
我们系统支持哪些财务系统的凭证集成	系统集成方面的技术咨询	我们支持哪几种国产数据库
怎样显示项目任务的进度图表?	我们的项目管理模块，项目状态是谁有权限修改的	项目流程创建不成功
请问h5宣传页面，应该找谁，走什么流程	android原生与h5页面的的交互	如何集成第三方h5应用？
会议节点检测有什么作用	会议权限范围问题	建模二开、需求评估问题
在客户管理中新建了销售机会后能不能自动转换为客户合同?	契约锁产品合法合规性	契约锁产品可以和哪些系统进行对接
流程分享可设置为能否查看流转意见的需求有计划吗	流程流转相关问题	文档能限制分享功能吗？
我们支持哪些国产cpu芯片	我们支持哪些国产操作系统	我们支持哪几种国产数据库
项目业绩核算有问题找谁？	我的业绩完成多少了	项目实施成本是多少？
契约锁做过哪些行业的客户？	在哪里可以查看到契约锁案例？	推荐朋友应聘契约锁找谁
会议室设置中的负责人什么用	为什么会议流程归档了，会议室没有占用呢？	下午有个算法工程师来面试，帮忙接待下
契约锁私有化有哪些场景？	契约锁私有化系统如何部署？	在收款未结算表中写未验收是什么情况？
契约锁的私有化系统是什么？	契约锁私有化系统如何部署？	在收款未结算表中写未验收是什么情况？
sap提供webservice接口或rest接口，oa是否可以调用，将流程的审批数据推送到sap？	webservice调用	最新的webservice文档
督查督办管理权限监控权限有何区别	开启分权后目录的维护权限怎么不生效了？	我要修改什么默认设置项，在系统哪张表？
电子证书过期找谁咨询？	要投标人员资质证书	阿里云系统配置
如何关闭快捷搜索中的微搜？	微搜为什么搜索不到数据？	请问手机客户端登录不上怎么处理？
emessage开发任务是否能够提前交付	请问emobile7问题找谁？	em7问题
外部人员是否占用license数	客户用户数不够用，可以多申请吗？	申请licence只剩下质保期尾款未结清，也只能申请临时三个月？
督查督办成文对模板有什么要求？	我绩效错了	我要修改绩效考核方案
e-office10.0 流程出口条件设置过程中需要注意的一些事项？	e-office常见的内部平台访问地址有哪些？	e-office实施过程中如何搭建外网访问oa系统？
云桥会务系统中可以实现红包功能吗	云桥会务系统销售问题	云桥怎么升级
客户门户能否自定义菜单和门户首页，客户门户是否支持移动端登录	移动端问题咨询	移动门户问题
云桥能够集成的企业应用有哪些	云桥怎么集成微信	云桥如何集成第三方app
报表功能需要采购哪个第三方	自定义报表相关问题	第三方硬件如何开票？
文档附件docx类型文件无法在线打开是什么问题？	公文管理相关问题	文档能限制分享功能吗？
云桥能够集成的app有哪些？	云桥怎么集成微信	云桥如何集成第三方app
你这边是否有云桥e-bridge文档资料	云桥怎么集成微信	云桥如何集成第三方app
统一待办中心功能需求分析文档在哪找	oa申请了非标准功能【统一待办中心】，第3方系统要如何将待办消息推送到oa？	数据中心产品咨询，配置，需求相关问题？
资产相关流程提交不成功	资产要清理数据，重新导入	资产导入报错
请问公司vi系统资料如何提供	分公司自用资料申请	我要寄快递
报销流程归档后能否直接生成凭证?	报销归档后，银行未有短信提醒，费用报销是否打款	费用报销的周期
moboile的考勤功能是否是标准的	移动门户问题	moboile是否支持集群
不同版本的建模应用能不能互相导入使用	应用如何用建模构建	能否用建模实现xx功能
流程关联了预算后提交报错	已收款未结算是什么情况？	报销归档后，银行未有短信提醒，费用报销是否打款
项目任务甘特图显示问题	项目流程创建不成功	项目创建菜单为空白
e-office公司，产品资质有哪些？	要投标人员资质证书	e-office常见的内部平台访问地址有哪些？
在已办事宜中查看，流程的显示模板当前节点的模板吗？	我想要个工作微博模板	我要要个总结报告模板
为什么修改留痕，修订者的信息显示为word登录账号	苹果端word文档有些打不开？	登录页面问题
已发生、审批中费用能在哪里查询到	售前支持成本是多少，与销售业绩里售前成本不一致？	费用报销的周期
在设置中客户管理里的销售机会下的“时间设置”有什么作用?	售前支持成本是多少，与销售业绩里售前成本不一致？	客户管理，车辆管理产品咨询，配置，需求相关问题？
能否支持按部门、个人、费用科目维度的管理费用及按项目维度的预算导入？	项目实施成本是多少？	售前支持成本是多少，与销售业绩里售前成本不一致？
预算变更流程提交后预算没有发生变化	售前支持成本是多少，与销售业绩里售前成本不一致？	已收款未结算是什么情况？
客户想关闭部分流程接口怎么办	我想开通流程权限	资产导入报错
公众号连接成功后就要配置菜单，会不会把原来客户微信的菜单给同步掉呀？	微搜为什么搜索不到数据？	请问手机客户端登录不上怎么处理？
客户需要定制app需要如何处理	android原生app的集成开发相关问题？	门户主题与元素问题
移动引擎能否实现可视化图标控件？	移动建模引擎功能白皮书有吗	移动端问题咨询
资产领用、归还等动作如何与流程关联?	资产要清理数据，重新导入	流程超时相关问题
预算编制完整导入和部分导入什么区别	资产导入报错	建模二开、需求评估问题
云桥能干么？	云桥如何配置流程	云桥怎么集成微信
流程中承担主体不显示	报销流程承担公司选不了怎么办	客户要求多公司分摊合同金额，发票如何操作？
启信宝如何集成	云桥怎么集成微信	云桥和钉钉、微信企业号、微信服务号怎么集成
e-cology系统有好多个人的建议，我该怎么来提	ecology有哪些功能	e-office常见的内部平台访问地址有哪些？
emessage聊天信息推送给企业微信；云桥如何配置？	云桥和钉钉、微信企业号、微信服务号怎么集成	云桥怎么集成微信
oa是否能将组织架构和人员信息同步到ad域或openldap中，即ad域或openldap中的数据由oa进行维护？	系统集成方面的技术咨询	e-office实施过程中如何搭建外网访问oa系统？
契约锁的产品都有哪些？	契约锁产品如何报价	在哪里可以查看到契约锁案例？
你们提供系统和数据库维护服务吗?	我们支持哪几种国产数据库	e-office集成外部数据库支持的类型有哪些?
e-ffice10.0 内部系统外发如何配置?	e-ffice10.0 如何快捷的迁移系统？	demo搭建考试时间安排
客户管理里的合同管理是可以上传附件吗	附件无法上传问题	客户用户数不够用，可以多申请吗？
误操作完成的督办任务如何重新开启	流程超时相关问题	项目流程创建不成功
数据库有没有什么优化的方案	我们支持哪几种国产数据库	e-office集成外部数据库支持的类型有哪些?
契约锁私有化如何与ec集成？	契约锁私有化系统如何部署？	在收款未结算表中写未验收是什么情况？
云桥会务系统访问地址是？	云桥会务系统销售问题	云桥怎么升级
e9如何与企业微信、钉钉集成	云桥和钉钉、微信企业号、微信服务号怎么集成	系统集成方面的技术咨询
ofd集成问题	第3方系统如何单点登录oa，有几种方式，能提供相应的方案吗？	系统集成方面的技术咨询
预算数、已发生、审批中数据的查询sql怎么写	我们支持哪几种国产数据库	怎样触发流程进行数据审批
我想申请之前二开的源码	二次开发扣款对应哪个流程？二次开发成本是多少？	文档目录自定义字段存储哪张表？如何查看
客户问企业认证正常情况下多久可以通过？	要投标人员资质证书	客户用户数不够用，可以多申请吗？
2019-07-30 16:39:34.278676
